,gre_score,gre_score_quant,gre_score_verbal,test_score_toefl,undergraduation_score,work_ex,papers_published,status
0,316,164,152,99.0,3.12,12,0,reject
1,316,164,152,99.0,3.12,12,0,reject
2,316,160,156,114,2.97,0,0,reject
3,317,168,149,106.0,2.83,15,0,reject
4,317,161,156,106.0,2.01,0,0,reject
5,299,151,148,101,3.0,35,0,reject
6,325,168,157,105.0,2.95,28,0,reject
7,314,164,150,103.0,3.2,3,1,reject
8,326,165,161,109.0,2.59,1,3,reject
9,328,169,159,106.0,2.84,30,0,reject
10,322,163,159,106.0,2.71,2,2,reject
11,300,160,140,99.0,2.71,24,3,reject
12,312,162,150,102.0,2.52,30,3,reject
13,316,159,157,104.0,1.89,43,0,reject
14,322,162,160,114.0,2.76,16,2,reject
15,316,164,152,99.0,3.12,12,0,reject
16,316,164,152,99.0,3.12,12,0,reject
17,316,160,156,114,2.97,0,0,reject
18,317,168,149,106.0,2.83,15,0,reject
19,317,161,156,106.0,2.01,0,0,reject
20,299,151,148,101,3.0,35,0,reject
21,325,168,157,105.0,2.95,28,0,reject
22,314,164,150,103.0,3.2,3,1,reject
23,326,165,161,109.0,2.59,1,3,reject
24,328,169,159,106.0,2.84,30,0,reject
25,322,163,159,106.0,2.71,2,2,reject
26,300,160,140,99.0,2.71,24,3,reject
27,312,162,150,102.0,2.52,30,3,reject
28,316,159,157,104.0,1.89,43,0,reject
29,322,162,160,114.0,2.76,16,2,reject
30,307,166,141,80.0,3.4,60,2,reject
31,330,168,162,113.0,2.98,34,2,reject
32,313,162,151,92.0,3.31,1,3,reject
33,313,162,151,92.0,3.31,1,3,reject
34,312,157,155,94.0,3.34,12,2,reject
35,321,164,157,110.0,1.21,4,3,reject
36,287,149,138,83.0,2.73,25,0,reject
37,315,158,157,113.0,2.38,17,2,reject
38,310,161,149,102.0,2.79,31,3,reject
39,312,164,148,101,3.0,30,0,reject
40,321,169,152,105.0,2.47,6,3,reject
41,327,169,158,106.0,2.84,41,0,reject
42,311,163,148,101,3.4,10,0,reject
43,304,153,151,104.0,2.85,24,0,reject
44,309,163,146,96.0,3.48,12,0,reject
45,300,157,143,99.0,3.3,30,0,reject
46,324,167,157,101.0,2.56,82,3,reject
47,312,157,155,110.0,2.86,25,3,reject
48,309,168,141,103.0,3.48,2,0,reject
49,310,158,152,97.0,2.26,57,0,reject
50,311,162,149,99.0,2.95,0,3,reject
51,315,165,150,97.0,3.53,24,0,reject
52,303,156,147,100.0,2.76,53,2,reject
53,307,157,150,93.0,3.05,25,0,reject
54,313,166,147,106.0,3.28,1,3,reject
55,322,170,152,101.0,2.81,25,3,reject
56,309,168,141,98.0,3.16,9,0,reject
57,308,159,149,95.0,3.36,14,0,reject
58,304,160,144,95.0,3.52,0,0,reject
59,311,166,145,97.0,3.35,0,0,reject
60,310,161,149,95.0,3.16,0,0,reject
61,311,159,152,93.0,2.94,15,0,reject
62,304,161,143,94.0,3.55,46,0,reject
63,310,158,152,103.0,2.08,60,0,reject
64,302,159,143,92.0,3.28,0,0,reject
65,305,145,160,101.0,1.95,50,2,reject
66,307,163,144,65.0,2.4,40,0,reject
67,317,170,147,96.0,3.16,31,0,reject
68,302,160,142,86.0,2.56,60,0,reject
69,308,161,147,96.0,3.52,24,0,reject
70,306,160,146,94.0,3.34,18,3,reject
71,305,163,142,91.0,2.6,45,0,reject
72,312,165,147,91.0,2.6,60,0,reject
73,305,155,150,94.0,2.59,19,0,reject
74,310,157,153,96.0,2.92,13,3,reject
75,313,164,149,90.0,3.28,15,1,reject
76,313,162,151,95.0,3.2,0,0,reject
77,314,163,151,95.0,2.51,60,0,reject
78,312,161,151,96.0,2.75,18,0,reject
79,308,164,144,90.0,3.37,0,0,reject
80,307,158,149,114,2.63,34,0,reject
81,319,170,149,86.0,3.68,13,0,reject
82,319,170,149,86.0,3.68,13,0,reject
83,314,166,148,89.0,2.67,13,2,reject
84,308,165,143,96.0,2.2,92,0,reject
85,310,160,150,93.0,3.6,1,0,reject
86,317,161,156,75.0,3.12,0,0,reject
87,312,167,145,100.0,2.8,21,0,reject
88,320,161,159,75.0,2.44,1,0,reject
89,305,161,144,98.0,2.78,2,0,reject
90,316,164,152,107.0,3.44,3,0,reject
91,319,169,150,105.0,3.3,0,0,reject
92,292,155,137,65.0,2.68,5,1,reject
93,315,166,149,99.0,3.08,12,0,reject
94,311,165,146,95.0,3.52,0,0,reject
95,312,160,152,109.0,3.4,7,0,reject
96,293,157,136,87.0,2.0,15,0,reject
97,318,164,154,108.0,2.4,46,0,reject
98,318,164,154,108.0,2.4,46,0,reject
99,319,170,149,108.0,2.64,42,0,reject
100,306,159,147,97.0,3.32,24,3,reject
101,303,160,143,89.0,3.0,0,0,reject
102,309,158,151,0,2.48,60,0,reject
103,303,160,143,101,2.1,0,0,reject
104,320,160,160,82.0,3.45,10,0,reject
105,302,153,149,91.0,2.56,110,0,reject
106,313,164,149,96.0,2.46,7,0,reject
107,303,159,144,92.0,3.15,26,0,reject
108,322,169,153,113.0,2.89,2,0,reject
109,305,158,147,82.0,2.97,25,3,reject
110,305,159,146,101,3.45,37,0,reject
111,302,158,144,92.0,2.85,48,0,reject
112,329,168,161,113.0,3.06,40,0,reject
113,308,155,153,114,2.9,1,3,reject
114,308,157,151,101.0,3.18,0,1,reject
115,308,157,151,101.0,3.18,0,1,reject
116,325,167,158,109.0,3.06,0,0,reject
117,319,162,157,112.0,1.9,60,0,reject
118,319,164,155,115.0,1.43,0,0,reject
119,321,164,157,106.0,3.21,14,0,reject
120,293,156,137,79.0,2.0,63,0,reject
121,313,163,150,116.0,2.99,2,0,reject
122,309,167,142,96.0,2.47,0,0,reject
123,308,165,143,101,3.57,24,2,reject
124,318,166,152,75.0,3.27,0,0,reject
125,302,154,148,101,3.0,2,0,reject
126,317,165,152,101.0,2.35,18,3,reject
127,312,163,149,87.0,2.81,30,1,reject
128,318,166,152,0,3.35,28,0,reject
129,322,165,157,110.0,2.4,30,0,reject
130,306,157,149,0,2.1,11,3,reject
131,324,167,157,110.0,3.37,15,0,reject
132,316,166,150,96.0,2.52,34,0,reject
133,304,157,147,94.0,3.28,0,0,reject
134,319,170,149,0,2.54,8,0,reject
135,311,161,150,100.0,2.65,31,0,reject
136,320,163,157,114.0,2.92,0,0,reject
137,315,164,151,0,2.3,30,0,reject
138,319,164,155,114.0,3.23,60,0,reject
139,311,162,149,114,2.71,18,0,reject
140,303,158,145,99.0,3.86,12,0,reject
141,314,162,152,106.0,3.36,6,0,reject
142,319,166,153,91.0,3.14,0,3,reject
143,317,166,151,105.0,3.23,8,0,reject
144,318,165,153,95.0,3.14,30,0,reject
145,307,160,147,95.0,2.25,60,0,reject
146,311,163,148,101,3.68,24,3,reject
147,312,166,146,99.0,2.6,27,0,reject
148,303,142,161,101,3.7,19,0,reject
149,313,160,153,0,3.36,0,0,reject
150,313,163,150,0,3.08,0,0,reject
151,314,162,152,105.0,2.9,2,0,reject
152,288,153,135,79.0,2.94,19,3,reject
153,303,157,146,101,3.1,23,0,reject
154,312,166,146,93.0,3.31,55,0,reject
155,319,165,154,110.0,3.88,1,3,reject
156,313,169,144,100.0,2.96,3,0,reject
157,317,169,148,96.0,2.98,24,3,reject
158,313,162,151,102.0,3.12,1,0,reject
159,308,160,148,0,2.84,1,0,reject
160,310,163,147,0,3.24,14,3,reject
161,315,166,149,98.0,3.36,1,3,reject
162,322,165,157,111.0,2.15,20,0,reject
163,312,164,148,97.0,3.65,27,3,reject
164,310,160,150,97.0,3.51,41,0,reject
165,322,161,161,109.0,2.9,7,1,reject
166,312,147,165,106.0,2.75,15,3,reject
167,312,147,165,106.0,2.75,15,3,reject
168,320,164,156,0,2.55,51,0,reject
169,313,165,148,75.0,3.09,0,0,reject
170,316,163,153,110.0,3.56,23,0,reject
171,300,156,144,93.0,3.62,24,0,reject
172,321,167,154,113.0,2.1,24,0,reject
173,323,163,160,110.0,2.96,0,0,reject
174,301,153,148,95.0,1.82,12,3,reject
175,313,163,150,96.0,3.44,28,0,reject
176,310,165,145,104.0,2.96,5,0,reject
177,303,158,145,101.0,3.62,0,3,reject
178,311,161,150,101.0,3.36,0,0,reject
179,304,156,148,102.0,3.05,42,0,reject
180,323,156,167,107.0,3.02,36,0,reject
181,308,160,148,103.0,3.42,24,0,reject
182,308,160,148,103.0,3.42,24,0,reject
183,307,162,145,105.0,2.13,4,3,reject
184,304,160,144,99.0,3.6,0,0,reject
185,315,164,151,108.0,3.17,8,0,reject
186,315,161,154,112.0,2.36,12,3,reject
187,313,161,152,110.0,3.05,4,0,reject
188,318,167,151,104.0,3.12,13,0,reject
189,308,156,152,0,2.77,28,0,reject
190,306,154,152,109.0,3.41,0,0,reject
191,314,161,153,100.0,2.2,0,0,reject
192,319,164,155,112.0,2.6,5,0,reject
193,310,158,152,96.0,2.54,1,3,reject
194,304,160,144,99.0,3.1,2,0,reject
195,310,161,149,0,3.52,0,0,reject
196,320,167,153,0,3.04,1,2,reject
197,312,163,149,107.0,3.42,30,0,reject
198,318,163,155,110.0,3.33,51,0,reject
199,313,161,152,0,2.53,17,0,reject
200,310,159,151,103.0,3.31,15,3,reject
201,314,161,153,0,2.83,17,3,reject
202,310,158,152,96.0,2.25,33,0,reject
203,316,168,148,98.0,3.04,16,2,reject
204,319,169,150,101.0,3.03,8,0,reject
205,320,162,158,0,2.8,31,0,reject
206,309,160,149,106.0,3.15,26,0,reject
207,319,166,153,97.0,3.42,21,0,reject
208,315,163,152,103.0,3.24,40,3,reject
209,303,158,145,94.0,2.6,35,0,reject
210,318,168,150,107.0,3.27,1,0,reject
211,305,155,150,114,2.98,0,0,reject
212,317,168,149,102.0,2.98,3,0,reject
213,325,170,155,105.0,3.3,24,0,reject
214,307,160,147,75.0,3.48,11,0,reject
215,314,163,151,104.0,3.31,0,1,reject
216,307,161,146,112.0,3.53,36,3,reject
217,315,160,155,75.0,3.33,42,0,reject
218,303,154,149,104.0,3.17,5,0,reject
219,314,164,150,92.0,2.6,18,0,reject
220,313,165,148,0,2.58,10,2,reject
221,314,164,150,105.0,3.31,1,3,reject
222,310,163,147,0,3.24,14,3,reject
223,315,166,149,98.0,3.36,1,3,reject
224,314,163,151,114.0,2.27,18,0,reject
225,312,164,148,97.0,3.65,27,3,reject
226,310,160,150,97.0,3.51,41,0,reject
227,306,157,149,107.0,2.61,11,0,reject
228,312,147,165,106.0,2.75,15,3,reject
229,312,147,165,106.0,2.75,15,3,reject
230,320,164,156,0,2.55,51,0,reject
231,304,156,148,104.0,2.7,25,0,reject
232,316,163,153,110.0,3.56,23,0,reject
233,300,156,144,93.0,3.62,24,0,reject
234,321,167,154,113.0,2.1,24,0,reject
235,301,153,148,95.0,1.82,12,3,reject
236,313,163,150,96.0,3.44,28,0,reject
237,311,161,150,111.0,2.69,24,0,reject
238,303,158,145,101.0,3.62,0,3,reject
239,311,161,150,101.0,3.36,0,0,reject
240,306,157,149,102.0,2.1,0,3,reject
241,323,156,167,107.0,3.02,36,0,reject
242,308,160,148,103.0,3.42,24,0,reject
243,308,160,148,103.0,3.42,24,0,reject
244,311,162,149,104.0,2.45,0,0,reject
245,304,160,144,99.0,3.6,0,0,reject
246,315,164,151,108.0,3.17,8,0,reject
247,315,161,154,112.0,2.36,12,3,reject
248,314,166,148,103.0,2.85,18,3,reject
249,318,167,151,104.0,3.12,13,0,reject
250,308,156,152,0,2.77,28,0,reject
251,306,154,152,109.0,3.41,0,0,reject
252,322,167,155,107.0,2.86,27,3,reject
253,319,164,155,112.0,2.6,5,0,reject
254,310,158,152,96.0,2.54,1,3,reject
255,304,160,144,99.0,3.1,2,0,reject
256,312,160,152,0,3.06,0,3,reject
257,320,167,153,0,3.04,1,2,reject
258,312,163,149,107.0,3.42,30,0,reject
259,312,163,149,107.0,3.42,30,0,reject
260,313,161,152,0,2.53,17,0,reject
261,310,159,151,103.0,3.31,15,3,reject
262,314,161,153,0,2.83,17,3,reject
263,305,158,147,0,2.8,3,0,reject
264,316,168,148,98.0,3.04,16,2,reject
265,319,169,150,101.0,3.03,8,0,reject
266,320,162,158,0,2.8,31,0,reject
267,308,161,147,65.0,3.23,29,0,reject
268,319,166,153,97.0,3.42,21,0,reject
269,315,163,152,103.0,3.24,40,3,reject
270,303,158,145,94.0,2.6,35,0,reject
271,302,152,150,0,3.56,2,0,reject
272,305,155,150,114,2.98,0,0,reject
273,317,168,149,102.0,2.98,3,0,reject
274,325,170,155,105.0,3.3,24,0,reject
275,319,168,151,107.0,2.0,0,0,reject
276,329,167,162,106.0,2.15,36,0,reject
277,311,162,149,0,2.76,29,0,reject
278,308,164,144,100.0,3.28,1,3,reject
279,316,160,156,102.0,2.39,1,0,reject
280,310,162,148,95.0,3.12,53,0,reject
281,312,157,155,98.0,2.6,27,2,reject
282,310,160,150,101.0,3.26,0,0,reject
283,310,165,145,65.0,2.81,16,0,reject
284,319,167,152,110.0,2.4,18,0,reject
285,320,164,156,112.0,2.33,15,3,reject
286,304,160,144,102.0,2.71,0,0,reject
287,307,158,149,106.0,3.4,4,3,reject
288,312,162,150,113.0,3.74,4,3,reject
289,319,167,152,100.0,3.33,51,0,reject
290,323,168,155,104.0,3.48,7,3,reject
291,320,168,152,106.0,2.92,17,0,reject
292,312,163,149,114,3.21,3,0,reject
293,310,157,153,99.0,2.55,21,0,reject
294,314,158,156,111.0,3.33,23,0,reject
295,316,170,146,98.0,2.8,30,0,reject
296,303,153,150,75.0,2.22,36,0,reject
297,312,162,150,102.0,3.2,18,0,reject
298,315,166,149,108.0,3.13,15,3,reject
299,304,152,152,106.0,3.26,28,0,reject
300,317,160,157,0,2.85,5,0,reject
301,319,161,158,111.0,2.96,6,0,reject
302,311,168,143,102.0,3.44,0,0,reject
303,310,166,144,114,2.42,0,0,reject
304,317,162,155,0,3.2,34,0,reject
305,319,164,155,114,2.37,0,0,reject
306,313,163,150,75.0,3.28,20,0,reject
307,317,164,153,107.0,3.36,18,0,reject
308,306,164,142,107.0,3.5,4,3,reject
309,316,167,149,100.0,2.9,6,0,reject
310,324,167,157,109.0,3.63,20,0,reject
311,323,167,156,0,3.54,6,3,reject
312,306,162,144,0,3.24,8,3,reject
313,302,155,147,98.0,3.2,29,1,reject
314,326,165,161,118.0,2.35,0,0,reject
315,304,158,146,75.0,3.0,0,0,reject
316,303,160,143,98.0,2.92,30,0,reject
317,309,161,148,106.0,3.09,0,0,reject
318,298,157,141,90.0,2.5,28,0,reject
319,299,159,140,0,2.81,1,0,reject
320,317,160,157,108.0,3.36,29,0,reject
321,318,167,151,101.0,2.6,36,0,reject
322,306,156,150,75.0,3.38,1,0,reject
323,306,156,150,75.0,3.38,1,0,reject
324,309,160,149,90.0,1.81,50,0,reject
325,313,163,150,96.0,3.45,0,0,reject
326,312,160,152,0,2.45,13,0,reject
327,317,163,154,111.0,2.82,24,3,reject
328,304,160,144,87.0,2.25,40,0,reject
329,322,168,154,104.0,3.36,50,0,reject
330,312,161,151,97.0,3.45,0,0,reject
331,308,159,149,93.0,1.96,33,3,reject
332,320,163,157,101.0,2.5,27,3,reject
333,310,164,146,102.0,2.62,28,0,reject
334,325,165,160,114.0,2.66,33,0,reject
335,330,165,165,118.0,3.56,7,0,reject
336,309,159,150,104.0,3.14,17,0,reject
337,305,155,150,101,2.65,24,2,reject
338,291,152,139,101,2.45,7,0,reject
339,291,152,139,101,2.45,7,0,reject
340,312,150,162,0,3.44,0,0,reject
341,310,160,150,103.0,3.42,36,0,reject
342,317,167,150,99.0,3.3,30,0,reject
343,315,169,146,98.0,3.15,24,0,reject
344,308,160,148,98.0,2.42,6,3,reject
345,322,170,152,107.0,3.56,39,0,reject
346,313,163,150,0,2.94,23,3,reject
347,308,163,145,0,2.87,0,0,reject
348,310,161,149,90.0,2.65,48,0,reject
349,304,162,142,95.0,2.4,3,3,reject
350,306,158,148,0,3.84,30,0,reject
351,310,163,147,101.0,3.06,14,3,reject
352,316,165,151,112.0,3.09,1,1,reject
353,306,159,147,96.0,2.61,44,0,reject
354,309,160,149,93.0,2.85,2,3,reject
355,309,160,149,93.0,2.85,2,3,reject
356,320,170,150,104.0,3.42,9,0,reject
357,303,162,141,101,3.27,12,0,reject
358,307,164,143,101.0,3.24,34,0,reject
359,305,160,145,104.0,3.31,20,0,reject
360,313,162,151,97.0,3.12,28,0,reject
361,324,165,159,110.0,2.6,12,0,reject
362,307,160,147,111.0,2.8,0,0,reject
363,307,156,151,102.0,2.8,0,0,reject
364,324,169,155,112.0,3.1,14,0,reject
365,312,167,145,0,3.12,33,0,reject
366,312,162,150,0,3.45,1,3,reject
367,306,161,145,75.0,2.89,18,3,reject
368,327,168,159,115.0,2.8,15,0,reject
369,319,167,152,107.0,3.44,0,0,reject
370,326,167,159,0,2.0,36,0,reject
371,311,160,151,108.0,3.18,50,0,reject
372,316,163,153,104.0,3.04,21,0,reject
373,304,159,145,96.0,2.52,20,0,reject
374,318,165,153,116.0,2.23,25,0,reject
375,312,161,151,109.0,3.21,18,0,reject
376,317,165,152,105.0,3.08,1,0,reject
377,319,164,155,109.0,2.88,4,0,reject
378,322,167,155,101.0,2.69,26,3,reject
379,308,160,148,101,2.85,0,3,reject
380,311,156,155,98.0,2.76,12,0,reject
381,313,167,146,93.0,3.52,30,0,reject
382,316,166,150,99.0,2.4,0,0,reject
383,311,162,149,96.0,3.33,2,1,reject
384,307,157,150,0,3.23,8,0,reject
385,322,169,153,111.0,3.15,41,0,reject
386,313,161,152,106.0,3.1,0,3,reject
387,323,166,157,0,3.23,25,3,reject
388,318,162,156,0,3.8,0,0,reject
389,304,160,144,100.0,3.12,1,0,reject
390,316,163,153,96.0,2.86,4,0,reject
391,315,168,147,104.0,2.96,15,3,reject
392,317,159,158,99.0,3.31,38,0,reject
393,307,161,146,101.0,3.32,20,0,reject
394,318,158,160,111.0,2.05,12,3,reject
395,307,161,146,101,3.17,2,3,reject
396,312,167,145,101,3.42,0,0,reject
397,313,162,151,98.0,3.16,15,3,reject
398,314,162,152,91.0,2.82,15,0,reject
399,300,155,145,103.0,3.1,2,0,reject
400,313,170,143,65.0,2.63,9,0,reject
401,314,162,152,111.0,3.11,1,0,reject
402,305,155,150,101.0,3.36,24,3,reject
403,307,159,148,93.0,2.98,15,3,reject
404,311,162,149,105.0,2.45,0,0,reject
405,311,162,149,105.0,2.45,0,0,reject
406,326,170,156,111.0,3.47,20,0,reject
407,325,166,159,111.0,2.7,30,0,reject
408,319,162,157,104.0,3.3,18,0,reject
409,307,158,149,107.0,2.92,12,0,reject
410,309,158,151,109.0,3.08,23,3,reject
411,312,167,145,85.0,3.3,30,0,reject
412,309,159,150,99.0,3.2,42,0,reject
413,308,159,149,101,2.69,0,0,reject
414,320,169,151,106.0,3.01,25,0,reject
415,323,165,158,109.0,2.88,2,0,reject
416,307,166,141,101,3.62,22,3,reject
417,312,163,149,103.0,3.4,13,0,reject
418,306,161,145,100.0,3.26,0,3,reject
419,318,167,151,103.0,2.84,10,3,reject
420,310,160,150,0,3.51,4,0,reject
421,312,161,151,104.0,2.5,2,1,reject
422,306,157,149,95.0,3.12,42,0,reject
423,309,163,146,100.0,3.5,15,0,reject
424,307,160,147,101.0,3.48,19,0,reject
425,311,162,149,0,2.25,29,0,reject
426,307,164,143,93.0,3.21,22,3,reject
427,316,162,154,96.0,2.82,24,0,reject
428,307,158,149,105.0,2.72,10,3,reject
429,324,169,155,112.0,3.16,15,3,reject
430,308,163,145,83.0,3.36,2,0,reject
431,307,159,148,75.0,3.44,0,3,reject
432,307,161,146,101.0,2.1,33,0,reject
433,310,155,155,111.0,2.96,15,0,reject
434,310,155,155,111.0,2.96,15,0,reject
435,318,160,158,0,2.91,0,0,reject
436,319,160,159,111.0,3.14,10,3,reject
437,317,169,148,95.0,3.24,0,0,reject
438,311,167,144,101.0,3.21,10,0,reject
439,316,163,153,0,3.73,1,0,reject
440,322,167,155,113.0,3.56,0,0,reject
441,314,165,149,108.0,2.08,0,1,reject
442,306,163,143,92.0,2.99,7,1,reject
443,311,163,148,101.0,3.56,22,0,reject
444,321,167,154,112.0,3.44,37,0,reject
445,323,167,156,110.0,3.0,29,0,reject
446,322,166,156,108.0,3.28,45,0,reject
447,325,170,155,106.0,2.59,31,0,reject
448,316,162,154,117.0,3.64,4,1,reject
449,314,168,146,0,3.23,0,0,reject
450,307,160,147,75.0,3.48,11,0,reject
451,315,166,149,0,3.08,4,0,reject
452,320,164,156,114.0,2.54,29,0,reject
453,311,164,147,105.0,3.2,15,3,reject
454,313,160,153,107.0,2.4,11,0,reject
455,315,166,149,98.0,3.26,26,0,reject
456,303,152,151,94.0,2.99,38,0,reject
457,308,162,146,0,2.57,6,0,reject
458,308,162,146,0,2.57,6,0,reject
459,300,156,144,95.0,2.9,16,3,reject
460,308,163,145,87.0,2.67,48,1,reject
461,313,165,148,96.0,3.57,6,0,reject
462,321,167,154,114.0,3.08,0,3,reject
463,315,167,148,0,2.94,0,3,reject
464,324,170,154,106.0,3.48,27,0,reject
465,308,158,150,100.0,2.65,0,0,reject
466,314,162,152,112.0,2.07,11,3,reject
467,318,166,152,102.0,2.77,8,3,reject
468,308,161,147,0,1.94,36,3,reject
469,312,161,151,0,3.14,2,0,reject
470,315,163,152,92.0,3.04,26,0,reject
471,318,160,158,109.0,2.87,41,0,reject
472,324,167,157,112.0,2.65,6,3,reject
473,312,166,146,86.0,3.0,38,0,reject
474,312,166,146,86.0,3.0,38,0,reject
475,312,148,164,90.0,3.39,33,0,reject
476,322,152,170,101.0,2.72,0,0,reject
477,309,164,145,94.0,2.92,2,0,reject
478,300,155,145,93.0,3.12,13,0,reject
479,310,162,148,95.0,3.2,0,3,reject
480,301,155,146,102.0,2.8,1,0,reject
481,311,160,151,94.0,2.72,52,0,reject
482,308,158,150,105.0,3.21,0,0,reject
483,328,168,160,0,2.72,19,3,reject
484,316,164,152,101.0,1.95,14,2,reject
485,313,159,154,104.0,2.88,19,0,reject
486,312,157,155,108.0,2.84,24,3,reject
487,315,161,154,101.0,3.31,12,0,reject
488,331,170,161,111.0,2.4,0,0,reject
489,320,162,158,0,3.14,19,3,reject
490,313,164,149,101.0,2.96,33,3,reject
491,313,164,149,101.0,2.96,33,3,reject
492,321,170,151,103.0,3.12,22,3,reject
493,318,165,153,107.0,2.4,30,2,reject
494,321,167,154,113.0,2.15,28,0,reject
495,320,165,155,108.0,3.4,18,0,reject
496,304,163,141,98.0,3.31,0,0,reject
497,309,164,145,92.0,3.22,0,0,reject
498,319,165,154,97.0,3.3,18,0,reject
499,323,168,155,104.0,3.64,20,3,reject
500,322,167,155,117.0,3.53,2,3,reject
501,320,170,150,104.0,2.25,35,0,reject
502,315,165,150,103.0,3.75,4,1,reject
503,311,167,144,99.0,3.18,7,0,reject
504,308,157,151,96.0,3.01,15,0,reject
505,328,163,165,0,2.25,0,0,reject
506,313,156,157,105.0,3.23,17,3,reject
507,321,170,151,75.0,3.32,0,0,reject
508,311,165,146,104.0,2.82,0,0,reject
509,308,160,148,106.0,2.5,0,0,reject
510,325,167,158,113.0,3.44,14,0,reject
511,309,163,146,94.0,3.65,2,0,reject
512,315,164,151,105.0,3.32,27,0,reject
513,303,161,142,99.0,3.53,0,3,reject
514,314,166,148,104.0,3.63,5,0,reject
515,308,166,142,0,3.37,0,0,reject
516,310,159,151,103.0,3.18,39,0,reject
517,311,160,151,111.0,2.49,26,2,reject
518,318,160,158,110.0,2.14,21,0,reject
519,320,163,157,102.0,2.75,31,0,reject
520,316,164,152,91.0,2.6,0,0,reject
521,317,151,166,108.0,3.2,2,0,reject
522,317,165,152,95.0,2.44,18,2,reject
523,310,162,148,106.0,3.44,12,3,reject
524,308,158,150,91.0,2.18,0,0,reject
525,315,159,156,114.0,3.14,0,0,reject
526,320,168,152,0,2.99,27,0,reject
527,313,163,150,107.0,2.96,13,3,reject
528,322,166,156,103.0,2.25,8,3,reject
529,312,160,152,106.0,2.92,0,0,reject
530,316,163,153,0,2.68,15,3,reject
531,320,165,155,101.0,2.51,1,0,reject
532,317,162,155,0,3.56,16,0,reject
533,315,165,150,102.0,2.45,0,0,reject
534,320,164,156,0,3.36,30,0,reject
535,318,161,157,0,2.95,13,0,reject
536,308,161,147,107.0,3.49,57,2,reject
537,314,162,152,108.0,2.95,20,0,reject
538,314,162,152,108.0,2.95,20,0,reject
539,310,164,146,106.0,2.07,13,3,reject
540,306,160,146,0,3.1,18,0,reject
541,315,161,154,0,2.84,1,0,reject
542,313,156,157,114,2.25,1,0,reject
543,314,166,148,98.0,3.26,16,0,reject
544,319,165,154,106.0,3.59,2,0,reject
545,307,157,150,105.0,2.22,26,0,reject
546,310,161,149,112.0,3.4,25,0,reject
547,327,170,157,112.0,3.08,32,3,reject
548,314,167,147,90.0,2.3,56,0,reject
549,305,161,144,88.0,2.9,36,0,reject
550,314,162,152,101.0,2.85,6,0,reject
551,309,159,150,105.0,3.32,30,3,reject
552,311,161,150,110.0,3.28,20,1,reject
553,328,170,158,108.0,3.21,0,0,reject
554,323,170,153,102.0,3.6,4,0,reject
555,323,170,153,102.0,3.6,4,0,reject
556,304,160,144,91.0,3.2,57,0,reject
557,317,162,155,101.0,3.49,24,0,reject
558,311,162,149,107.0,3.13,3,3,reject
559,320,170,150,111.0,3.26,22,0,reject
560,309,159,150,114,2.3,20,0,reject
561,303,161,142,87.0,3.47,20,0,reject
562,305,155,150,98.0,3.44,12,0,reject
563,304,161,143,94.0,2.3,35,0,reject
564,319,170,149,0,3.32,0,3,reject
565,311,165,146,75.0,2.78,15,3,reject
566,308,158,150,100.0,2.97,25,0,reject
567,326,168,158,0,3.22,1,3,reject
568,303,160,143,95.0,3.0,0,0,reject
569,311,158,153,114.0,3.61,5,0,reject
570,311,158,153,116.0,2.37,43,0,reject
571,314,162,152,89.0,3.12,0,0,reject
572,314,162,152,89.0,3.12,0,0,reject
573,311,163,148,93.0,1.13,0,0,reject
574,306,162,144,107.0,3.24,0,0,reject
575,304,156,148,99.0,2.9,23,0,reject
576,302,160,142,92.0,2.81,16,0,reject
577,315,165,150,103.0,2.55,42,0,reject
578,311,151,160,94.0,3.25,35,0,reject
579,300,158,142,95.0,3.02,27,0,reject
580,309,159,150,108.0,2.7,12,2,reject
581,310,161,149,91.0,2.6,29,0,reject
582,313,162,151,102.0,2.9,33,0,reject
583,314,165,149,102.0,2.43,7,1,reject
584,301,156,145,89.0,2.95,2,0,reject
585,307,160,147,93.0,2.84,0,0,reject
586,313,155,158,106.0,2.23,0,0,reject
587,303,154,149,105.0,1.77,0,0,reject
588,313,157,156,89.0,2.12,0,0,reject
589,310,163,147,95.0,3.25,4,0,reject
590,314,164,150,101,1.8,1,0,reject
591,308,160,148,100.0,2.31,0,0,reject
592,302,154,148,101,3.32,0,0,reject
593,298,152,146,99.0,2.0,36,0,reject
594,317,160,157,109.0,2.63,0,0,reject
595,312,162,150,103.0,2.68,0,0,reject
596,329,167,162,118.0,3.12,2,0,reject
597,323,167,156,95.0,2.59,0,3,reject
598,316,164,152,108.0,2.02,0,3,reject
599,304,157,147,93.0,2.46,3,0,reject
600,305,155,150,96.0,3.09,20,0,reject
601,316,162,154,115.0,3.72,6,3,reject
602,321,167,154,112.0,2.4,18,0,reject
603,304,164,140,75.0,2.6,54,0,reject
604,323,162,161,113.0,2.15,11,0,reject
605,308,156,152,92.0,3.13,19,0,reject
606,308,156,152,92.0,3.13,19,0,reject
607,322,168,154,114.0,2.1,40,0,reject
608,307,160,147,102.0,2.5,30,0,reject
609,313,163,150,104.0,2.15,74,0,reject
610,312,162,150,107.0,2.88,20,0,reject
611,308,157,151,113.0,2.25,29,0,reject
612,311,158,153,102.0,2.15,14,3,reject
613,311,160,151,96.0,3.08,2,0,reject
614,320,166,154,108.0,3.11,20,0,reject
615,309,161,148,98.0,1.06,2,0,reject
616,308,159,149,82.0,3.64,0,0,reject
617,310,162,148,94.0,3.05,37,0,reject
618,308,158,150,94.0,3.4,12,0,reject
619,315,165,150,96.0,3.05,9,0,reject
620,309,162,147,94.0,3.01,18,0,reject
621,309,162,147,94.0,3.01,18,0,reject
622,307,158,149,107.0,2.28,40,0,reject
623,305,160,145,89.0,2.37,21,3,reject
624,307,155,152,97.0,2.4,17,3,reject
625,318,161,157,103.0,2.39,36,0,reject
626,303,162,141,91.0,3.07,17,0,reject
627,309,155,154,95.0,2.35,18,0,reject
628,310,157,153,110.0,2.35,38,0,reject
629,311,153,158,108.0,2.15,36,3,reject
630,305,160,145,90.0,3.23,30,0,reject
631,305,156,149,102.0,3.35,0,0,reject
632,319,167,152,93.0,3.44,3,0,reject
633,313,166,147,0,1.99,29,0,reject
634,301,157,144,93.0,2.6,5,0,reject
635,310,163,147,75.0,3.18,0,0,reject
636,294,153,141,83.0,2.18,78,0,reject
637,294,153,141,83.0,2.18,78,0,reject
638,315,167,148,93.0,3.0,2,0,reject
639,308,161,147,104.0,2.1,3,0,reject
640,315,163,152,103.0,2.85,44,0,reject
641,315,162,153,106.0,2.3,60,0,reject
642,314,165,149,110.0,3.24,0,0,reject
643,318,167,151,100.0,3.47,1,0,reject
644,300,156,144,102.0,2.15,20,0,reject
645,310,161,149,95.0,3.41,19,0,reject
646,309,160,149,105.0,2.62,15,1,reject
647,302,153,149,89.0,3.32,24,0,reject
648,307,162,145,93.0,2.54,16,0,reject
649,328,165,163,110.0,2.6,60,0,reject
650,316,167,149,89.0,2.75,19,0,reject
651,307,161,146,91.0,3.39,18,0,reject
652,311,165,146,96.0,2.5,5,0,reject
653,311,165,146,96.0,2.5,5,0,reject
654,312,161,151,95.0,3.04,0,0,reject
655,317,165,152,111.0,3.25,6,0,reject
656,294,157,137,87.0,2.75,60,0,reject
657,317,163,154,112.0,3.6,21,2,reject
658,311,162,149,92.0,3.14,0,0,reject
659,308,163,145,90.0,2.27,0,1,reject
660,311,162,149,112.0,3.16,1,0,reject
661,303,158,145,91.0,2.5,4,2,reject
662,320,170,150,103.0,3.06,32,0,reject
663,320,167,153,103.0,3.28,18,0,reject
664,298,161,137,90.0,2.85,21,0,reject
665,307,163,144,94.0,2.2,0,2,reject
666,313,164,149,108.0,2.16,32,3,reject
667,305,161,144,89.0,2.36,55,0,reject
668,323,166,157,112.0,2.5,5,3,reject
669,311,168,143,91.0,3.56,8,3,reject
670,303,159,144,88.0,2.87,36,0,reject
671,321,170,151,105.0,3.47,7,3,reject
672,311,160,151,105.0,2.1,32,2,reject
673,305,158,147,105.0,2.89,2,0,reject
674,314,165,149,93.0,2.76,42,0,reject
675,314,165,149,94.0,2.73,45,0,reject
676,307,158,149,97.0,3.34,0,0,reject
677,310,159,151,107.0,3.55,44,0,reject
678,308,164,144,94.0,2.52,36,3,reject
679,299,156,143,100.0,2.4,29,0,reject
680,308,160,148,100.0,1.8,0,2,reject
681,313,159,154,113.0,3.46,24,0,reject
682,319,170,149,93.0,2.4,8,3,reject
683,328,167,161,113.0,2.37,35,2,reject
684,313,163,150,99.0,2.82,25,0,reject
685,316,164,152,97.0,2.92,9,0,reject
686,310,158,152,109.0,2.3,21,3,reject
687,308,159,149,104.0,3.45,3,3,reject
688,323,164,159,109.0,3.41,1,0,reject
689,316,170,146,104.0,3.6,18,3,reject
690,309,163,146,90.0,3.26,6,0,reject
691,311,161,150,92.0,2.92,44,0,reject
692,321,167,154,112.0,3.02,30,0,reject
693,306,161,145,98.0,2.21,36,0,reject
694,317,162,155,102.0,1.85,14,2,reject
695,330,167,163,115.0,2.1,19,0,reject
696,301,159,142,84.0,2.4,36,0,reject
697,304,156,148,107.0,2.65,28,0,reject
698,308,162,146,89.0,3.12,21,0,reject
699,308,161,147,90.0,3.36,54,0,reject
700,305,158,147,91.0,1.92,26,3,reject
701,308,159,149,104.0,2.64,14,2,reject
702,316,163,153,98.0,2.18,51,0,reject
703,316,163,153,98.0,2.18,51,0,reject
704,312,164,148,89.0,3.43,32,3,reject
705,309,166,143,95.0,1.34,33,0,reject
706,324,170,154,103.0,3.54,2,3,reject
707,320,170,150,101.0,2.74,46,3,reject
708,310,163,147,95.0,3.27,4,0,reject
709,318,165,153,104.0,3.42,14,2,reject
710,330,170,160,113.0,3.4,36,0,reject
711,317,162,155,104.0,2.17,77,0,reject
712,310,162,148,97.0,3.2,0,0,reject
713,300,158,142,96.0,3.58,69,0,reject
714,312,160,152,86.0,2.5,12,3,reject
715,322,165,157,109.0,2.45,16,1,reject
716,302,158,144,91.0,2.08,21,3,reject
717,317,164,153,102.0,2.15,0,0,reject
718,309,161,148,89.0,2.59,31,0,reject
719,313,168,145,95.0,1.9,7,1,reject
720,313,168,145,95.0,1.9,7,1,reject
721,309,161,148,106.0,2.1,53,0,reject
722,304,161,143,104.0,2.34,19,0,reject
723,317,166,151,93.0,2.0,0,0,reject
724,307,158,149,93.0,1.9,60,0,reject
725,321,161,160,114.0,2.72,0,0,reject
726,319,167,152,99.0,3.0,6,3,reject
727,322,168,154,102.0,2.5,2,0,reject
728,311,163,148,95.0,3.28,0,0,reject
729,315,167,148,99.0,2.82,8,3,reject
730,315,160,155,114.0,2.28,12,0,reject
731,316,170,146,100.0,3.2,25,0,reject
732,310,164,146,97.0,3.11,24,0,reject
733,303,162,141,87.0,3.41,36,0,reject
734,303,155,148,93.0,3.31,21,0,reject
735,308,164,144,96.0,3.2,0,3,reject
736,309,158,151,103.0,3.08,44,1,reject
737,309,158,151,103.0,3.08,44,1,reject
738,309,166,143,95.0,3.04,1,0,reject
739,315,166,149,75.0,3.45,47,0,reject
740,309,161,148,95.0,2.75,24,3,reject
741,309,161,148,96.0,2.78,20,3,reject
742,316,163,153,109.0,3.66,4,0,reject
743,323,169,154,105.0,3.13,24,0,reject
744,322,163,159,109.0,2.46,7,0,reject
745,304,162,142,97.0,3.36,15,3,reject
746,315,165,150,91.0,2.81,0,0,reject
747,318,166,152,100.0,2.36,19,3,reject
748,314,166,148,101.0,2.28,31,0,reject
749,307,162,145,92.0,3.74,30,0,reject
750,306,161,145,105.0,3.36,34,3,reject
751,307,163,144,107.0,3.08,30,2,reject
752,322,161,161,107.0,3.4,0,0,reject
753,316,165,151,99.0,3.03,16,0,reject
754,329,168,161,111.0,1.95,1,0,reject
755,305,159,146,93.0,2.1,78,0,reject
756,305,159,146,97.0,2.02,27,3,reject
757,321,166,155,105.0,2.91,5,0,reject
758,306,157,149,91.0,2.17,25,0,reject
759,304,149,155,88.0,2.36,46,0,reject
760,300,144,156,92.0,2.98,2,3,reject
761,330,170,160,111.0,2.6,8,0,reject
762,301,159,142,90.0,2.19,12,3,reject
763,310,161,149,93.0,3.14,0,0,reject
764,308,159,149,97.0,2.47,32,0,reject
765,322,168,154,101,3.22,15,0,reject
766,316,164,152,111.0,3.36,0,0,reject
767,327,168,159,114.0,3.51,2,3,reject
768,315,167,148,103.0,2.55,0,3,reject
769,310,168,142,101.0,2.76,42,3,reject
770,312,161,151,109.0,2.11,0,3,reject
771,321,167,154,105.0,2.3,46,0,reject
772,309,161,148,102.0,2.9,30,0,reject
773,315,168,147,101.0,3.1,0,0,reject
774,316,170,146,98.0,3.36,1,2,reject
775,310,162,148,91.0,3.05,25,0,reject
776,314,166,148,110.0,3.3,8,3,reject
777,318,160,158,106.0,2.59,50,3,reject
778,315,167,148,103.0,3.25,30,0,reject
779,318,167,151,110.0,2.62,0,0,reject
780,310,164,146,107.0,3.32,13,1,reject
781,330,167,163,114.0,2.88,28,0,reject
782,310,160,150,108.0,2.15,15,3,reject
783,308,164,144,103.0,3.63,2,3,reject
784,309,157,152,98.0,3.21,3,3,reject
785,309,157,152,98.0,3.21,3,3,reject
786,321,161,160,111.0,2.55,32,0,reject
787,308,160,148,65.0,3.24,19,0,reject
788,318,167,151,101.0,3.6,14,0,reject
789,320,169,151,114.0,3.53,12,3,reject
790,317,165,152,109.0,2.8,23,0,reject
791,305,158,147,106.0,2.51,48,0,reject
792,315,161,154,107.0,2.2,24,0,reject
793,312,163,149,105.0,2.96,2,0,reject
794,314,166,148,93.0,3.32,0,0,reject
795,319,164,155,106.0,3.52,1,3,reject
796,323,154,169,103.0,3.14,3,0,reject
797,313,161,152,96.0,2.25,10,0,reject
798,315,164,151,103.0,2.0,30,3,reject
799,304,156,148,105.0,2.27,132,0,reject
800,319,166,153,105.0,2.72,24,0,reject
801,307,161,146,104.0,3.33,24,0,reject
802,307,161,146,104.0,3.33,24,0,reject
803,315,161,154,104.0,3.42,2,0,reject
804,332,170,162,115.0,2.62,4,3,reject
805,309,160,149,99.0,2.61,1,0,reject
806,311,164,147,99.0,3.16,30,0,reject
807,307,158,149,96.0,2.65,0,0,reject
808,323,164,159,109.0,2.79,5,0,reject
809,312,163,149,105.0,2.95,29,0,reject
810,324,170,154,110.0,3.43,2,0,reject
811,319,163,156,105.0,2.8,0,0,reject
812,318,164,154,94.0,1.85,33,3,reject
813,311,163,148,101.0,3.56,0,0,reject
814,311,161,150,99.0,3.43,1,0,reject
815,322,168,154,109.0,3.43,36,3,reject
816,317,165,152,109.0,2.67,33,0,reject
817,313,167,146,97.0,2.58,18,0,reject
818,318,168,150,104.0,2.64,22,0,reject
819,318,168,150,104.0,2.64,22,0,reject
820,320,166,154,109.0,3.14,40,0,reject
821,319,167,152,0,2.7,0,0,reject
822,307,158,149,98.0,1.95,44,2,reject
823,311,161,150,92.0,2.75,18,0,reject
824,306,157,149,89.0,3.6,21,0,reject
825,323,165,158,112.0,2.2,40,0,reject
826,323,169,154,94.0,3.51,31,0,reject
827,306,158,148,100.0,2.65,18,0,reject
828,305,156,149,91.0,3.19,18,3,reject
829,310,163,147,101.0,3.08,0,0,reject
830,304,161,143,90.0,3.58,0,0,reject
831,313,168,145,94.0,3.19,3,0,reject
832,310,164,146,102.0,3.28,34,0,reject
833,318,167,151,102.0,2.27,40,0,reject
834,310,160,150,95.0,2.91,42,0,reject
835,302,160,142,75.0,2.25,3,0,reject
836,326,167,159,114.0,3.07,0,0,reject
837,314,162,152,100.0,3.42,2,3,reject
838,323,170,153,103.0,3.16,26,0,reject
839,323,170,153,109.0,3.37,16,0,reject
840,310,162,148,102.0,2.45,18,0,reject
841,331,164,167,114.0,2.75,19,0,reject
842,326,167,159,117.0,2.6,0,3,reject
843,326,167,159,109.0,3.4,0,2,reject
844,306,158,148,99.0,2.35,15,1,reject
845,318,164,154,113.0,2.4,30,3,reject
846,320,167,153,106.0,3.47,8,3,reject
847,309,165,144,97.0,2.99,22,0,reject
848,310,160,150,95.0,2.54,30,0,reject
849,308,159,149,92.0,3.6,1,0,reject
850,306,161,145,96.0,2.75,36,0,reject
851,303,160,143,89.0,3.32,24,0,reject
852,314,159,155,75.0,2.85,23,0,reject
853,318,168,150,106.0,1.88,18,3,reject
854,309,161,148,91.0,3.62,20,0,reject
855,312,163,149,100.0,3.73,16,1,reject
856,313,161,152,96.0,3.04,0,0,reject
857,310,163,147,104.0,2.76,2,0,reject
858,322,170,152,100.0,2.77,0,0,reject
859,318,165,153,109.0,2.05,55,0,reject
860,311,167,144,113.0,3.11,0,0,reject
861,324,167,157,112.0,2.96,39,0,reject
862,319,167,152,110.0,3.8,16,3,reject
863,327,170,157,115.0,3.04,12,0,reject
864,309,162,147,96.0,2.65,41,0,reject
865,323,161,162,107.0,3.33,22,2,reject
866,305,158,147,97.0,3.47,3,3,reject
867,310,160,150,110.0,2.36,18,0,reject
868,310,160,150,110.0,2.36,18,0,reject
869,317,165,152,104.0,2.02,17,0,reject
870,314,160,154,107.0,2.11,15,3,reject
871,312,162,150,98.0,2.06,19,3,reject
872,316,166,150,100.0,2.26,7,3,reject
873,317,161,156,108.0,1.9,14,0,reject
874,318,168,150,102.0,2.05,42,0,reject
875,318,163,155,107.0,2.58,36,0,reject
876,303,163,140,85.0,3.41,6,0,reject
877,290,149,141,84.0,2.7,48,0,reject
878,301,159,142,78,3.0,32,0,reject
879,302,154,148,100.0,3.25,24,0,reject
880,329,169,160,112.0,1.96,36,0,reject
881,306,163,143,93.0,3.13,42,0,reject
882,309,163,146,90.0,3.16,6,0,reject
883,305,161,144,89.0,3.09,12,0,reject
884,316,167,149,98.0,3.17,24,0,reject
885,316,167,149,98.0,3.17,24,0,reject
886,307,157,150,96.0,3.19,43,0,reject
887,311,163,148,85.0,3.05,24,0,reject
888,309,161,148,109.0,3.25,4,0,reject
889,308,157,151,104.0,3.2,20,0,reject
890,311,163,148,106.0,2.05,30,0,reject
891,316,163,153,103.0,2.14,9,3,reject
892,323,165,158,114.0,2.75,8,3,reject
893,311,155,156,101,3.16,18,0,reject
894,308,163,145,95.0,2.29,24,0,reject
895,303,165,138,91.0,3.45,18,0,reject
896,316,164,152,98.0,2.15,55,0,reject
897,312,162,150,99.0,2.72,6,0,reject
898,300,156,144,65.0,3.2,24,3,reject
899,312,164,148,94.0,2.8,24,1,reject
900,312,161,151,99.0,2.8,30,0,reject
901,299,158,141,83.0,2.45,30,0,reject
902,299,158,141,83.0,2.45,30,0,reject
903,301,157,144,88.0,2.92,0,0,reject
904,315,161,154,113.0,2.17,22,0,reject
905,318,166,152,94.0,2.5,11,0,reject
906,313,158,155,110.0,2.45,30,2,reject
907,302,156,146,94.0,3.4,17,0,reject
908,310,162,148,96.0,2.9,60,0,reject
909,306,164,142,83.0,3.12,38,0,reject
910,306,162,144,93.0,3.48,45,0,reject
911,319,166,153,101.0,2.5,6,0,reject
912,325,170,155,108.0,3.0,4,0,reject
913,312,158,154,100.0,3.0,41,0,reject
914,309,159,150,100.0,1.7,50,0,reject
915,313,164,149,107.0,3.02,36,0,reject
916,308,159,149,106.0,2.6,0,3,reject
917,304,158,146,93.0,2.98,0,0,reject
918,309,156,153,106.0,3.26,18,2,reject
919,315,165,150,110.0,3.24,24,0,reject
920,310,159,151,104.0,2.8,24,2,reject
921,316,164,152,104.0,2.65,70,0,reject
922,323,170,153,96.0,2.15,24,0,reject
923,301,154,147,103.0,2.35,8,0,reject
924,304,155,149,105.0,2.0,26,0,reject
925,314,161,153,106.0,3.1,30,0,reject
926,300,158,142,91.0,3.04,15,3,reject
927,308,156,152,97.0,3.03,24,0,reject
928,317,158,159,105.0,2.1,40,0,reject
929,313,163,150,106.0,2.85,0,0,reject
930,303,156,147,103.0,2.78,30,2,reject
931,323,167,156,110.0,3.17,0,0,reject
932,318,164,154,107.0,3.16,0,0,reject
933,323,162,161,108.0,2.6,59,0,reject
934,319,170,149,96.0,2.72,5,0,reject
935,309,162,147,96.0,3.42,22,0,reject
936,312,163,149,102.0,3.38,0,0,reject
937,315,163,152,105.0,2.65,0,0,reject
938,321,161,160,105.0,2.8,36,0,reject
939,305,163,142,83.0,2.8,24,0,reject
940,312,162,150,100.0,2.4,48,0,reject
941,315,163,152,111.0,2.5,10,0,reject
942,305,160,145,104.0,3.1,2,0,reject
943,307,160,147,102.0,2.76,0,0,reject
944,309,160,149,99.0,2.28,20,0,reject
945,312,162,150,103.0,2.99,40,0,reject
946,304,154,150,95.0,2.44,0,3,reject
947,308,155,153,95.0,2.4,0,0,reject
948,314,159,155,107.0,2.3,30,0,reject
949,308,154,154,96.0,2.25,30,1,reject
950,319,165,154,109.0,2.2,0,1,reject
951,319,165,154,109.0,2.2,0,1,reject
952,328,170,158,115.0,2.68,0,3,reject
953,314,160,154,100.0,3.12,2,0,reject
954,315,163,152,111.0,2.35,23,3,reject
955,309,160,149,91.0,2.48,0,0,reject
956,322,166,156,113.0,3.1,0,0,reject
957,320,168,152,100.0,3.2,0,0,reject
958,304,158,146,94.0,2.84,26,0,reject
959,309,161,148,98.0,3.48,1,0,reject
960,320,170,150,97.0,3.09,18,0,reject
961,308,159,149,98.0,2.01,30,0,reject
962,311,167,144,98.0,3.66,1,0,reject
963,308,162,146,97.0,2.84,0,0,reject
964,306,154,152,95.0,2.5,19,0,reject
965,307,161,146,99.0,3.0,0,0,reject
966,306,160,146,96.0,3.36,6,0,reject
967,316,162,154,104.0,2.78,2,0,reject
968,316,162,154,104.0,2.78,2,0,reject
969,314,165,149,102.0,2.5,54,0,reject
970,309,159,150,103.0,2.45,30,0,reject
971,314,158,156,107.0,2.61,4,0,reject
972,305,159,146,93.0,2.18,30,0,reject
973,298,154,144,65.0,3.26,11,0,reject
974,310,157,153,108.0,1.95,32,0,reject
975,309,166,143,89.0,2.15,23,0,reject
976,320,166,154,111.0,2.98,22,0,reject
977,309,162,147,103.0,2.68,21,3,reject
978,310,163,147,107.0,2.9,0,0,reject
979,316,163,153,107.0,2.6,0,0,reject
980,316,163,153,112.0,2.6,12,3,reject
981,314,158,156,105.0,2.35,20,3,reject
982,309,158,151,106.0,2.5,7,0,reject
983,313,161,152,92.0,3.26,9,0,reject
984,317,161,156,109.0,3.45,6,0,reject
985,317,161,156,109.0,3.45,6,0,reject
986,314,162,152,108.0,3.54,0,0,reject
987,319,162,157,109.0,1.86,0,3,reject
988,316,164,152,104.0,3.0,0,0,reject
989,313,170,143,102.0,3.42,21,0,reject
990,319,165,154,104.0,3.26,0,0,reject
991,311,159,152,100.0,3.6,0,0,reject
992,313,163,150,107.0,3.31,0,0,reject
993,302,157,145,97.0,3.2,24,1,reject
994,321,169,152,108.0,1.96,0,0,reject
995,305,157,148,97.0,2.45,0,0,reject
996,312,163,149,107.0,3.22,0,0,reject
997,313,161,152,113.0,2.6,41,0,reject
998,318,168,150,104.0,2.3,30,3,reject
999,310,164,146,85.0,2.53,6,0,reject
1000,321,167,154,104.0,2.25,18,0,reject
1001,308,158,150,101.0,2.8,22,0,reject
1002,325,168,157,114.0,2.89,0,0,reject
1003,308,161,147,104.0,2.43,24,3,reject
1004,309,155,154,114.0,3.44,0,0,reject
1005,316,162,154,102.0,2.94,60,0,reject
1006,312,163,149,106.0,2.45,17,0,reject
1007,300,155,145,92.0,3.0,36,1,reject
1008,307,162,145,91.0,2.9,2,0,reject
1009,303,154,149,93.0,3.4,0,2,reject
1010,318,167,151,100.0,2.55,24,0,reject
1011,306,158,148,102.0,2.92,0,3,reject
1012,304,160,144,94.0,2.25,0,0,reject
1013,306,157,149,90.0,2.85,0,0,reject
1014,320,168,152,96.0,3.48,5,0,reject
1015,306,161,145,91.0,3.65,20,0,reject
1016,325,166,159,104.0,2.76,2,0,reject
1017,311,163,148,105.0,2.4,0,0,reject
1018,307,162,145,108.0,2.05,0,0,reject
1019,309,159,150,105.0,2.35,0,0,reject
1020,306,162,144,99.0,1.99,10,0,reject
1021,311,164,147,106.0,3.34,1,3,reject
1022,313,155,158,106.0,2.23,0,0,reject
1023,326,170,156,108.0,1.8,0,0,reject
1024,324,165,159,114.0,3.57,30,0,reject
1025,311,164,147,96.0,3.0,6,0,reject
1026,322,162,160,108.0,2.2,0,0,reject
1027,311,158,153,108.0,2.2,15,2,reject
1028,320,168,152,110.0,2.5,30,0,reject
1029,313,166,147,97.0,3.32,0,0,reject
1030,322,168,154,114.0,3.2,0,3,reject
1031,305,157,148,102.0,2.05,0,0,reject
1032,311,161,150,95.0,2.22,0,0,reject
1033,316,164,152,102.0,2.55,30,0,reject
1034,310,161,149,106.0,3.1,0,0,reject
1035,310,161,149,106.0,3.1,0,0,reject
1036,316,161,155,102.0,2.15,20,0,reject
1037,312,163,149,99.0,2.78,0,2,reject
1038,307,159,148,93.0,2.5,0,3,reject
1039,313,161,152,103.0,2.21,0,2,reject
1040,322,165,157,110.0,2.11,0,0,reject
1041,306,158,148,104.0,2.5,30,0,reject
1042,323,163,160,108.0,2.03,20,0,reject
1043,309,159,150,105.0,2.8,0,0,reject
1044,310,165,145,95.0,3.05,32,0,reject
1045,308,158,150,109.0,2.1,0,0,reject
1046,306,159,147,97.0,2.12,10,0,reject
1047,320,163,157,108.0,2.3,0,2,reject
1048,306,161,145,96.0,3.19,0,0,reject
1049,312,162,150,103.0,2.56,0,0,reject
1050,310,160,150,110.0,2.5,0,0,reject
1051,310,160,150,94.0,3.24,0,3,reject
1052,310,160,150,94.0,3.24,0,3,reject
1053,306,161,145,104.0,3.02,22,0,reject
1054,308,159,149,93.0,2.46,30,3,reject
1055,318,165,153,107.0,3.0,0,0,reject
1056,311,164,147,108.0,3.0,0,3,reject
1057,307,160,147,97.0,2.05,10,3,reject
1058,318,164,154,117.0,2.44,30,0,reject
1059,307,155,152,110.0,2.0,12,0,reject
1060,313,162,151,96.0,2.86,0,0,reject
1061,321,167,154,108.0,2.35,10,0,reject
1062,318,168,150,102.0,2.81,10,0,reject
1063,312,166,146,90.0,3.94,10,0,reject
1064,320,165,155,113.0,2.4,14,0,reject
1065,304,161,143,92.0,3.6,24,0,reject
1066,320,168,152,96.0,3.14,20,0,reject
1067,308,158,150,99.0,2.4,16,0,reject
1068,317,167,150,103.0,2.35,30,2,reject
1069,317,167,150,103.0,2.35,30,2,reject
1070,313,163,150,99.0,2.9,30,0,reject
1071,296,158,138,98.0,2.1,30,0,reject
1072,310,165,145,100.0,2.15,30,3,reject
1073,313,162,151,110.0,2.65,30,0,reject
1074,315,163,152,95.0,2.35,30,3,reject
1075,308,163,145,104.0,2.17,30,1,reject
1076,322,170,152,101.0,2.4,30,0,reject
1077,325,169,156,104.0,2.6,30,1,reject
1078,304,157,147,95.0,3.29,30,0,reject
1079,316,164,152,106.0,2.9,9,3,accept
1080,314,163,151,114,3.53,7,3,accept
1081,307,160,147,88.0,3.0,36,0,accept
1082,330,169,161,113.0,2.4,48,3,accept
1083,316,163,153,99.0,2.71,30,0,accept
1084,311,163,148,107.0,3.22,0,0,accept
1085,306,155,151,113.0,3.12,12,0,accept
1086,325,168,157,106.0,2.65,8,3,accept
1087,324,167,157,104.0,3.44,0,0,accept
1088,317,159,158,114.0,3.52,4,1,accept
1089,324,167,157,108.0,3.12,6,2,accept
1090,305,161,144,0,3.28,13,0,accept
1091,324,169,155,112.0,2.88,8,0,accept
1092,318,170,148,102.0,2.8,4,0,accept
1093,312,164,148,65.0,3.68,5,0,accept
1094,319,165,154,99.0,2.87,30,2,accept
1095,306,157,149,100.0,3.56,20,0,accept
1096,304,157,147,95.0,2.82,0,0,accept
1097,306,157,149,111.0,3.55,0,0,accept
1098,332,170,162,115.0,2.75,9,0,accept
1099,317,162,155,101.0,3.46,48,0,accept
1100,309,163,146,102.0,3.1,33,0,accept
1101,320,168,152,99.0,3.3,25,3,accept
1102,305,153,152,107.0,2.75,24,0,accept
1103,323,164,159,110.0,3.12,12,0,accept
1104,318,166,152,104.0,3.47,9,3,accept
1105,327,167,160,115.0,3.19,2,0,accept
1106,320,168,152,107.0,3.52,41,3,accept
1107,324,163,161,110.0,3.64,28,0,accept
1108,311,155,156,101.0,3.13,0,0,accept
1109,318,165,153,112.0,3.66,36,3,accept
1110,315,160,155,106.0,3.76,4,0,accept
1111,321,164,157,104.0,2.88,15,0,accept
1112,317,163,154,112.0,3.4,11,3,accept
1113,332,170,162,114.0,3.28,32,2,accept
1114,316,167,149,103.0,3.45,19,0,accept
1115,313,161,152,106.0,3.33,0,0,accept
1116,315,158,157,100.0,3.0,0,0,accept
1117,316,164,152,98.0,3.26,33,0,accept
1118,319,163,156,112.0,3.4,0,0,accept
1119,318,162,156,108.0,3.8,20,3,accept
1120,322,165,157,118.0,3.56,1,0,accept
1121,312,161,151,108.0,3.33,2,0,accept
1122,320,167,153,107.0,3.5,0,3,accept
1123,318,166,152,110.0,3.14,6,0,accept
1124,320,165,155,108.0,3.46,5,3,accept
1125,318,167,151,108.0,2.94,24,0,accept
1126,320,170,150,107.0,3.68,4,0,accept
1127,315,165,150,114.0,3.8,1,0,accept
1128,308,153,155,75.0,3.21,50,0,accept
1129,310,161,149,100.0,2.92,4,0,accept
1130,338,168,170,119.0,3.68,6,0,accept
1131,315,165,150,105.0,2.59,9,3,accept
1132,313,161,152,114,3.82,1,0,accept
1133,308,156,152,102.0,3.06,7,3,accept
1134,312,162,150,106.0,2.96,0,0,accept
1135,312,163,149,107.0,3.24,25,0,accept
1136,316,163,153,102.0,3.05,6,0,accept
1137,316,165,151,110.0,3.08,9,0,accept
1138,316,164,152,108.0,3.82,3,3,accept
1139,324,169,155,108.0,3.29,30,2,accept
1140,317,161,156,114,2.8,10,0,accept
1141,310,167,143,101,3.19,0,3,accept
1142,329,170,159,108.0,3.38,16,0,accept
1143,310,161,149,106.0,3.14,60,0,accept
1144,316,161,155,101.0,3.5,1,0,accept
1145,316,162,154,100.0,3.46,0,0,accept
1146,317,160,157,111.0,2.61,36,0,accept
1147,321,168,153,109.0,3.27,2,0,accept
1148,318,169,149,100.0,2.89,30,0,accept
1149,311,161,150,102.0,3.66,16,0,accept
1150,319,163,156,113.0,3.44,10,0,accept
1151,325,170,155,110.0,3.44,33,0,accept
1152,320,167,153,104.0,3.46,24,0,accept
1153,320,168,152,101.0,3.44,17,0,accept
1154,327,165,162,109.0,2.87,30,0,accept
1155,314,162,152,104.0,2.96,43,0,accept
1156,319,167,152,110.0,3.14,24,0,accept
1157,326,164,162,110.0,2.96,31,0,accept
1158,327,170,157,109.0,3.33,8,0,accept
1159,320,166,154,102.0,3.42,22,0,accept
1160,314,162,152,105.0,3.47,14,0,accept
1161,306,146,160,101,3.59,60,0,accept
1162,324,170,154,113.0,3.56,31,2,accept
1163,313,164,149,103.0,2.4,27,3,accept
1164,316,164,152,105.0,3.42,24,3,accept
1165,317,165,152,106.0,3.62,0,3,accept
1166,311,163,148,102.0,3.41,28,0,accept
1167,305,160,145,75.0,3.63,6,0,accept
1168,322,155,167,109.0,3.0,20,3,accept
1169,311,160,151,107.0,2.7,60,0,accept
1170,320,165,155,103.0,3.59,4,0,accept
1171,321,167,154,111.0,3.6,6,0,accept
1172,317,166,151,104.0,3.43,6,0,accept
1173,316,164,152,106.0,3.07,28,0,accept
1174,315,164,151,108.0,3.62,1,0,accept
1175,321,163,158,109.0,3.16,44,0,accept
1176,329,166,163,114.0,2.66,18,0,accept
1177,320,170,150,104.0,3.86,2,1,accept
1178,319,163,156,110.0,3.14,60,0,accept
1179,314,162,152,108.0,3.73,2,0,accept
1180,314,166,148,107.0,3.05,18,0,accept
1181,314,160,154,109.0,2.96,24,0,accept
1182,322,168,154,108.0,2.5,7,2,accept
1183,307,158,149,104.0,3.68,1,0,accept
1184,306,157,149,114,3.15,0,3,accept
1185,313,164,149,110.0,2.9,7,0,accept
1186,309,162,147,101,3.8,0,0,accept
1187,317,169,148,75.0,2.88,26,2,accept
1188,315,162,153,109.0,3.89,1,0,accept
1189,318,161,157,114,3.26,33,0,accept
1190,309,160,149,75.0,3.37,30,0,accept
1191,327,168,159,0,3.74,0,0,accept
1192,299,148,151,75.0,2.62,55,0,accept
1193,321,167,154,109.0,3.0,0,0,accept
1194,319,162,157,106.0,3.34,36,0,accept
1195,317,163,154,118.0,3.5,15,2,accept
1196,328,170,158,114.0,2.99,17,0,accept
1197,318,168,150,100.0,3.08,14,0,accept
1198,331,165,166,115.0,2.35,46,0,accept
1199,310,156,154,105.0,3.38,5,3,accept
1200,327,164,163,117.0,3.28,16,0,accept
1201,309,160,149,101,3.5,24,3,accept
1202,317,165,152,114.0,2.64,24,0,accept
1203,313,164,149,75.0,3.57,12,0,accept
1204,314,159,155,111.0,2.7,52,0,accept
1205,321,170,151,100.0,3.36,3,0,accept
1206,318,163,155,109.0,2.4,49,0,accept
1207,318,163,155,114.0,2.94,24,0,accept
1208,315,160,155,75.0,3.01,13,0,accept
1209,313,169,144,100.0,3.07,20,0,accept
1210,317,166,151,102.0,3.5,13,0,accept
1211,312,160,152,107.0,2.96,17,0,accept
1212,326,165,161,100.0,2.84,0,0,accept
1213,320,161,159,113.0,2.7,82,0,accept
1214,316,162,154,107.0,3.19,4,3,accept
1215,322,167,155,108.0,3.16,60,0,accept
1216,325,169,156,112.0,3.38,5,0,accept
1217,318,163,155,108.0,3.32,18,0,accept
1218,318,170,148,101.0,3.25,7,0,accept
1219,308,163,145,75.0,3.1,12,0,accept
1220,313,163,150,101,3.0,18,0,accept
1221,327,164,163,111.0,3.46,22,0,accept
1222,312,163,149,105.0,2.7,22,2,accept
1223,327,170,157,104.0,3.53,18,0,accept
1224,315,161,154,107.0,2.3,36,0,accept
1225,325,159,166,115.0,3.48,1,0,accept
1226,309,164,145,105.0,3.59,2,0,accept
1227,333,168,165,114.0,3.61,2,0,accept
1228,317,162,155,111.0,3.24,1,0,accept
1229,329,166,163,114.0,3.25,3,0,accept
1230,319,168,151,106.0,2.05,38,0,accept
1231,321,163,158,110.0,3.37,6,0,accept
1232,315,164,151,103.0,3.81,32,0,accept
1233,322,166,156,103.0,3.23,28,0,accept
1234,323,170,153,112.0,3.29,12,3,accept
1235,308,158,150,106.0,3.08,0,0,accept
1236,317,164,153,101.0,3.71,50,0,accept
1237,316,165,151,93.0,3.37,52,3,accept
1238,330,167,163,114.0,2.4,6,0,accept
1239,310,159,151,75.0,2.88,58,0,accept
1240,316,163,153,112.0,3.24,24,0,accept
1241,320,162,158,108.0,3.24,28,3,accept
1242,306,158,148,101,2.65,0,0,accept
1243,314,162,152,98.0,3.4,18,2,accept
1244,309,161,148,101.0,2.9,51,0,accept
1245,313,162,151,111.0,3.44,22,3,accept
1246,313,166,147,108.0,3.46,0,0,accept
1247,313,161,152,107.0,3.27,6,2,accept
1248,317,170,147,106.0,3.19,24,0,accept
1249,324,168,156,106.0,3.0,26,0,accept
1250,306,157,149,111.0,3.0,49,0,accept
1251,312,160,152,104.0,3.0,24,0,accept
1252,329,168,161,110.0,3.39,3,2,accept
1253,311,164,147,102.0,3.02,27,3,accept
1254,311,165,146,101,2.2,0,0,accept
1255,317,163,154,105.0,3.29,48,0,accept
1256,310,165,145,101,3.69,15,0,accept
1257,322,163,159,115.0,2.4,22,3,accept
1258,306,159,147,99.0,2.56,29,1,accept
1259,315,162,153,102.0,2.94,31,2,accept
1260,315,163,152,107.0,3.42,0,3,accept
1261,310,165,145,101,2.92,0,0,accept
1262,311,159,152,114,3.34,43,0,accept
1263,318,165,153,102.0,3.57,38,0,accept
1264,323,170,153,107.0,3.66,8,0,accept
1265,312,167,145,99.0,3.3,13,2,accept
1266,307,157,150,104.0,2.62,11,0,accept
1267,326,164,162,110.0,3.24,0,0,accept
1268,307,157,150,107.0,3.4,6,3,accept
1269,324,166,158,112.0,2.18,20,0,accept
1270,316,163,153,0,2.45,27,0,accept
1271,319,164,155,0,3.43,1,3,accept
1272,318,166,152,0,2.93,17,0,accept
1273,314,163,151,106.0,2.74,46,3,accept
1274,321,160,161,111.0,2.8,24,0,accept
1275,328,166,162,0,2.35,24,3,accept
1276,318,167,151,112.0,2.9,2,3,accept
1277,320,161,159,114,2.8,12,1,accept
1278,319,166,153,0,2.5,2,0,accept
1279,315,164,151,108.0,3.18,17,3,accept
1280,314,164,150,108.0,3.48,2,0,accept
1281,322,167,155,107.0,3.28,15,0,accept
1282,315,166,149,105.0,3.68,18,3,accept
1283,314,162,152,105.0,3.4,41,0,accept
1284,320,166,154,104.0,3.62,5,3,accept
1285,329,170,159,116.0,3.64,10,3,accept
1286,312,158,154,104.0,2.96,30,3,accept
1287,321,165,156,105.0,3.0,39,0,accept
1288,332,166,166,115.0,3.52,22,0,accept
1289,329,165,164,113.0,3.16,18,0,accept
1290,324,166,158,120.0,3.75,2,0,accept
1291,317,165,152,102.0,3.09,13,0,accept
1292,330,169,161,116.0,3.43,12,2,accept
1293,304,154,150,105.0,3.2,31,3,accept
1294,320,162,158,102.0,3.32,6,3,accept
1295,325,166,159,113.0,2.76,12,0,accept
1296,319,166,153,112.0,3.42,4,0,accept
1297,326,162,164,111.0,2.76,1,0,accept
1298,309,162,147,105.0,3.32,0,0,accept
1299,320,162,158,117.0,3.37,2,2,accept
1300,319,168,151,0,3.16,14,3,accept
1301,314,161,153,108.0,3.34,17,0,accept
1302,314,162,152,105.0,3.39,4,0,accept
1303,312,154,158,104.0,1.24,2,0,accept
1304,322,162,160,112.0,3.57,12,0,accept
1305,328,163,165,114.0,2.99,69,0,accept
1306,326,167,159,112.0,3.67,5,0,accept
1307,317,165,152,110.0,3.47,0,0,accept
1308,317,166,151,104.0,3.44,2,0,accept
1309,309,157,152,108.0,3.1,26,0,accept
1310,323,168,155,110.0,3.52,5,2,accept
1311,316,162,154,110.0,3.82,16,3,accept
1312,320,165,155,0,2.7,22,3,accept
1313,313,163,150,106.0,3.42,0,1,accept
1314,316,164,152,110.0,3.04,0,0,accept
1315,315,164,151,104.0,2.97,2,0,accept
1316,316,162,154,114,3.38,0,0,accept
1317,321,167,154,113.0,3.54,2,2,accept
1318,321,168,153,106.0,3.4,0,0,accept
1319,334,170,164,117.0,3.28,0,3,accept
1320,318,164,154,0,3.26,16,0,accept
1321,316,159,157,110.0,3.36,36,0,accept
1322,316,164,152,0,3.6,22,3,accept
1323,322,169,153,110.0,3.16,52,0,accept
1324,316,162,154,110.0,3.81,16,3,accept
1325,319,161,158,110.0,3.64,12,0,accept
1326,320,166,154,105.0,3.58,4,3,accept
1327,328,170,158,113.0,3.18,44,0,accept
1328,325,169,156,117.0,3.37,2,3,accept
1329,323,167,156,114.0,2.92,4,0,accept
1330,318,165,153,102.0,2.93,18,2,accept
1331,320,162,158,112.0,3.02,28,0,accept
1332,315,160,155,109.0,3.59,2,3,accept
1333,320,162,158,118.0,2.98,14,0,accept
1334,317,165,152,0,3.34,24,3,accept
1335,316,161,155,113.0,3.17,26,0,accept
1336,322,167,155,112.0,3.17,18,3,accept
1337,316,164,152,103.0,3.1,6,0,accept
1338,324,167,157,111.0,2.85,40,1,accept
1339,316,163,153,104.0,3.05,8,0,accept
1340,315,165,150,102.0,2.46,29,2,accept
1341,308,162,146,104.0,3.07,7,0,accept
1342,303,152,151,100.0,3.0,24,3,accept
1343,319,164,155,115.0,2.95,24,0,accept
1344,310,158,152,107.0,2.88,19,0,accept
1345,319,163,156,114.0,3.05,16,0,accept
1346,334,166,168,114.0,2.46,0,0,accept
1347,319,154,165,102.0,2.25,0,0,accept
1348,314,163,151,109.0,2.82,0,0,accept
1349,311,166,145,98.0,2.15,0,0,accept
1350,299,157,142,97.0,2.22,0,0,accept
1351,302,155,147,109.0,2.9,0,0,accept
1352,310,160,150,95.0,3.13,0,0,accept
1353,312,150,162,104.0,2.1,0,0,accept
1354,309,154,155,104.0,3.26,0,0,accept
1355,320,163,157,108.0,2.92,18,0,accept
1356,321,167,154,110.0,2.88,13,0,accept
1357,318,166,152,113.0,3.19,9,0,accept
1358,323,166,157,113.0,1.42,6,3,accept
1359,314,152,162,112.0,3.24,29,0,accept
1360,322,167,155,112.0,3.26,18,0,accept
1361,316,163,153,108.0,3.33,21,0,accept
1362,316,167,149,105.0,3.24,0,3,accept
1363,319,162,157,105.0,2.9,5,3,accept
1364,313,158,155,103.0,3.32,24,2,accept
1365,314,160,154,108.0,3.32,29,3,accept
1366,318,162,156,101.0,2.55,48,0,accept
1367,311,163,148,101.0,2.92,28,0,accept
1368,320,165,155,106.0,2.9,22,0,accept
1369,304,159,145,102.0,2.75,36,0,accept
1370,327,168,159,114.0,3.37,0,0,accept
1371,316,164,152,106.0,2.73,20,0,accept
1372,323,161,162,114.0,2.81,27,0,accept
1373,310,154,156,103.0,2.34,28,3,accept
1374,313,162,151,102.0,2.92,27,0,accept
1375,306,154,152,102.0,2.91,31,2,accept
1376,309,161,148,101.0,3.04,16,2,accept
1377,313,164,149,101.0,3.44,24,0,accept
1378,313,158,155,103.0,3.32,15,2,accept
1379,311,160,151,110.0,3.72,24,0,accept
1380,314,167,147,100.0,3.68,8,3,accept
1381,316,164,152,109.0,3.34,18,0,accept
1382,318,164,154,101.0,3.47,0,3,accept
1383,319,164,155,111.0,2.8,20,0,accept
1384,320,167,153,104.0,2.8,36,0,accept
1385,317,163,154,113.0,2.56,21,1,accept
1386,316,168,148,113.0,2.85,45,0,accept
1387,316,158,158,119.0,2.99,14,2,accept
1388,317,168,149,100.0,2.95,46,2,accept
1389,319,163,156,104.0,3.04,2,0,accept
1390,319,162,157,105.0,3.52,21,0,accept
1391,316,164,152,102.0,2.92,0,3,accept
1392,325,168,157,112.0,3.3,9,3,accept
1393,311,162,149,104.0,3.51,0,2,accept
1394,313,159,154,112.0,3.0,0,0,accept
1395,316,160,156,102.0,3.15,40,0,accept
1396,319,160,159,117.0,2.83,30,0,accept
1397,312,163,149,101.0,3.01,22,0,accept
1398,329,166,163,113.0,2.86,30,0,accept
1399,308,156,152,99.0,3.04,24,0,accept
1400,312,158,154,109.0,3.22,4,0,accept
1401,310,162,148,99.0,2.85,24,0,accept
1402,314,162,152,99.0,3.15,7,0,accept
1403,319,170,149,107.0,3.18,20,0,accept
1404,317,164,153,99.0,3.59,25,3,accept
1405,314,168,146,103.0,3.52,2,0,accept
1406,312,160,152,108.0,3.6,0,0,accept
1407,313,163,150,99.0,2.95,7,0,accept
1408,315,162,153,108.0,3.16,4,0,accept
1409,313,162,151,110.0,2.67,3,3,accept
1410,320,163,157,115.0,3.04,1,0,accept
1411,320,162,158,104.0,3.1,1,0,accept
1412,315,166,149,107.0,3.76,6,0,accept
1413,318,166,152,112.0,3.29,0,0,accept
1414,314,161,153,107.0,3.13,42,3,accept
1415,309,157,152,101.0,3.24,13,0,accept
1416,322,166,156,102.0,3.48,19,0,accept
1417,314,161,153,111.0,3.75,26,0,accept
1418,324,170,154,98.0,2.36,0,0,accept
1419,311,159,152,103.0,3.08,1,0,accept
1420,315,162,153,108.0,2.58,12,0,accept
1421,318,168,150,106.0,3.55,15,3,accept
1422,315,165,150,100.0,3.33,1,0,accept
1423,316,167,149,106.0,3.4,7,3,accept
1424,320,165,155,108.0,3.15,2,0,accept
1425,310,163,147,100.0,2.45,17,3,accept
1426,314,162,152,105.0,3.56,0,1,accept
1427,325,168,157,110.0,3.08,19,0,accept
1428,316,164,152,101.0,3.66,0,0,accept
1429,315,162,153,109.0,2.7,6,3,accept
1430,322,168,154,111.0,2.92,6,0,accept
1431,310,159,151,101.0,2.4,32,0,accept
1432,313,150,163,103.0,3.35,38,0,accept
1433,309,154,155,104.0,3.28,0,0,accept
1434,315,161,154,110.0,3.26,48,0,accept
1435,309,160,149,101.0,3.05,2,2,accept
1436,317,170,147,105.0,2.8,3,0,accept
1437,307,159,148,111.0,2.74,40,0,accept
1438,313,163,150,110.0,3.73,36,3,accept
1439,314,155,159,105.0,3.39,36,0,accept
1440,317,165,152,108.0,3.07,0,1,accept
1441,317,165,152,107.0,3.1,0,0,accept
1442,315,152,163,105.0,2.1,25,3,accept
1443,315,170,145,108.0,2.9,2,0,accept
1444,315,162,153,100.0,3.3,60,0,accept
1445,326,165,161,112.0,2.55,23,0,accept
1446,317,162,155,110.0,3.17,5,3,accept
1447,315,160,155,104.0,2.35,12,3,accept
1448,319,168,151,106.0,3.49,7,3,accept
1449,315,164,151,110.0,3.3,22,0,accept
1450,309,157,152,103.0,2.8,67,0,accept
1451,320,150,170,107.0,3.28,17,3,accept
1452,324,168,156,110.0,3.36,2,0,accept
1453,319,160,159,107.0,3.48,13,0,accept
1454,310,160,150,99.0,2.55,48,0,accept
1455,303,154,149,109.0,3.0,0,3,accept
1456,309,158,151,102.0,3.22,17,0,accept
1457,321,167,154,112.0,3.24,12,0,accept
1458,318,163,155,101.0,2.88,4,3,accept
1459,310,161,149,103.0,2.38,24,0,accept
1460,307,159,148,99.0,2.73,15,0,accept
1461,309,163,146,104.0,2.64,32,0,accept
1462,320,167,153,103.0,3.38,40,0,accept
1463,329,167,162,117.0,3.47,2,0,accept
1464,317,164,153,107.0,2.81,20,0,accept
1465,317,165,152,111.0,3.79,24,0,accept
1466,312,162,150,109.0,2.65,36,0,accept
1467,318,167,151,111.0,2.48,35,0,accept
1468,321,166,155,117.0,3.48,0,0,accept
1469,307,155,152,75.0,2.98,27,0,accept
1470,311,160,151,109.0,3.07,0,0,accept
1471,324,168,156,107.0,3.27,7,0,accept
1472,317,168,149,102.0,3.26,1,0,accept
1473,316,167,149,109.0,3.09,0,2,accept
1474,313,167,146,111.0,2.76,30,1,accept
1475,300,151,149,102.0,2.4,42,0,accept
1476,311,162,149,100.0,2.69,30,1,accept
1477,319,165,154,109.0,3.16,5,0,accept
1478,311,167,144,101,3.02,12,0,accept
1479,312,157,155,109.0,2.8,30,0,accept
1480,306,163,143,101,3.3,19,0,accept
1481,305,160,145,107.0,3.24,14,0,accept
1482,316,166,150,106.0,3.2,15,3,accept
1483,309,163,146,101,3.15,25,0,accept
1484,319,162,157,108.0,2.68,0,0,accept
1485,306,157,149,101,1.38,1,0,accept
1486,310,162,148,102.0,2.59,30,1,accept
1487,312,159,153,102.0,2.3,0,0,accept
1488,307,158,149,105.0,2.96,48,1,accept
1489,307,158,149,107.0,3.06,22,0,accept
1490,314,162,152,107.0,2.4,9,0,accept
1491,313,167,146,100.0,2.97,13,0,accept
1492,329,166,163,102.0,2.86,30,0,accept
1493,300,151,149,105.0,2.9,42,0,accept
1494,313,166,147,106.0,2.7,0,2,accept
1495,312,161,151,109.0,3.04,4,0,accept
1496,317,164,153,112.0,3.28,0,3,accept
1497,314,163,151,106.0,2.3,24,0,accept
1498,312,163,149,101.0,2.95,21,0,accept
1499,312,160,152,109.0,2.65,9,0,accept
1500,306,158,148,98.0,2.5,3,3,accept
1501,313,165,148,101.0,2.56,50,0,accept
1502,322,170,152,110.0,2.67,24,3,accept
1503,319,161,158,118.0,2.33,0,0,accept
1504,309,158,151,75.0,3.27,11,0,accept
1505,309,165,144,75.0,3.54,0,0,accept
1506,314,159,155,109.0,2.95,40,0,accept
1507,312,165,147,107.0,3.47,31,0,accept
1508,318,167,151,103.0,3.38,18,3,accept
1509,326,165,161,115.0,2.71,0,3,accept
1510,315,156,159,110.0,2.95,0,0,accept
1511,305,158,147,99.0,2.84,0,3,accept
1512,321,167,154,108.0,3.44,2,0,accept
1513,320,167,153,101.0,2.89,0,0,accept
1514,322,170,152,110.0,3.48,0,0,accept
1515,315,164,151,105.0,3.16,9,0,accept
1516,317,167,150,99.0,2.6,9,3,accept
1517,317,165,152,101.0,2.3,0,0,accept
1518,309,160,149,100.0,2.4,30,2,accept
1519,312,162,150,104.0,3.44,20,3,accept
1520,310,157,153,104.0,3.3,30,0,accept
1521,319,166,153,113.0,2.64,24,0,accept
1522,314,164,150,108.0,3.38,3,3,accept
1523,319,170,149,102.0,3.24,33,0,accept
1524,289,147,142,92.0,2.3,60,0,accept
1525,309,157,152,98.0,3.61,28,0,accept
1526,305,162,143,103.0,3.6,4,3,accept
1527,315,162,153,104.0,3.48,24,0,accept
1528,322,170,152,111.0,3.15,22,0,accept
1529,298,152,146,101,2.25,10,0,accept
1530,324,170,154,105.0,3.31,10,0,accept
1531,331,167,164,112.0,2.62,32,3,accept
1532,319,164,155,103.0,2.45,9,0,accept
1533,314,162,152,108.0,2.6,30,0,accept
1534,320,170,150,104.0,2.65,0,0,accept
1535,324,170,154,101.0,3.08,24,3,accept
1536,313,165,148,103.0,3.16,10,3,accept
1537,315,167,148,99.0,2.8,0,3,accept
1538,322,166,156,113.0,3.0,30,3,accept
1539,318,164,154,101.0,2.73,40,0,accept
1540,313,160,153,111.0,3.1,36,0,accept
1541,311,162,149,108.0,3.34,0,0,accept
1542,317,165,152,101,3.2,10,0,accept
1543,316,164,152,101.0,3.56,36,0,accept
1544,320,165,155,105.0,2.3,39,1,accept
1545,311,161,150,103.0,3.03,10,3,accept
1546,316,166,150,108.0,3.24,24,3,accept
1547,317,164,153,104.0,2.9,28,0,accept
1548,326,168,158,110.0,3.24,0,2,accept
1549,316,170,146,105.0,3.08,36,3,accept
1550,323,165,158,112.0,3.4,60,0,accept
1551,302,156,146,100.0,2.23,30,0,accept
1552,316,167,149,100.0,3.28,0,1,accept
1553,312,160,152,102.0,3.0,16,0,accept
1554,305,159,146,102.0,2.75,0,3,accept
1555,313,163,150,93.0,3.13,12,0,accept
1556,323,167,156,107.0,2.45,22,3,accept
1557,315,153,162,102.0,2.86,48,3,accept
1558,321,169,152,113.0,2.75,1,3,accept
1559,310,166,144,101,3.15,20,0,accept
1560,306,160,146,100.0,3.2,30,3,accept
1561,311,167,144,100.0,3.08,7,0,accept
1562,307,161,146,102.0,3.64,30,0,accept
1563,317,165,152,107.0,3.65,0,3,accept
1564,320,168,152,102.0,3.2,30,0,accept
1565,316,161,155,108.0,3.51,0,0,accept
1566,323,166,157,117.0,3.68,10,3,accept
1567,319,167,152,113.0,3.66,2,3,accept
1568,323,166,157,117.0,3.68,0,3,accept
1569,320,166,154,114.0,3.0,10,2,accept
1570,306,163,143,98.0,2.25,30,0,accept
1571,322,167,155,104.0,3.2,10,0,accept
1572,323,170,153,106.0,2.8,18,0,accept
1573,324,170,154,102.0,2.53,0,1,accept
1574,318,160,158,112.0,3.14,0,0,accept
1575,312,161,151,108.0,3.42,0,0,accept
1576,309,159,150,100.0,2.75,30,3,accept
1577,309,159,150,103.0,3.1,0,1,accept
1578,326,168,158,108.0,3.45,30,0,accept
1579,317,168,149,104.0,3.05,20,2,accept
1580,317,162,155,110.0,2.6,0,0,accept
1581,320,164,156,113.0,2.75,0,0,accept
1582,316,164,152,104.0,2.6,30,3,accept
1583,326,162,164,117.0,3.2,20,3,accept
1584,310,165,145,101.0,3.01,6,2,accept
1585,314,164,150,100.0,2.35,0,1,accept
1586,307,161,146,101,2.29,0,0,accept
1587,308,164,144,100.0,2.75,0,0,accept
1588,311,161,150,106.0,2.4,20,0,accept
1589,314,165,149,100.0,2.9,0,2,accept
1590,315,162,153,110.0,3.15,0,0,accept
1591,322,164,158,113.0,2.68,0,0,accept
1592,311,162,149,111.0,3.02,20,0,accept
1593,318,163,155,108.0,2.55,10,0,accept
1594,327,164,163,117.0,2.6,20,0,accept
1595,306,156,150,113.0,2.59,0,0,accept
1596,314,163,151,109.0,3.64,30,0,accept
1597,314,158,156,106.0,3.58,30,2,accept
1598,308,159,149,108.0,2.97,20,0,accept
1599,317,162,155,111.0,2.6,10,0,accept
1600,322,167,155,106.0,2.7,0,0,accept
1601,316,161,155,102.0,2.6,20,2,accept
1602,314,158,156,107.0,3.35,20,0,accept
1603,315,163,152,110.0,2.85,30,3,accept
1604,313,161,152,114,3.24,30,3,accept
1605,308,157,151,99.0,3.23,30,0,accept
1606,304,155,149,106.0,3.41,27,0,accept
1607,317,165,152,103.0,3.68,30,0,accept
1608,309,155,154,106.0,2.61,30,0,accept
1609,324,162,162,85.0,3.18,30,0,accept
1610,309,157,152,103.0,3.4,30,0,accept
1611,316,165,151,96.0,1.97,30,0,accept
1612,312,163,149,101.0,3.02,30,0,accept
1613,313,164,149,105.0,3.22,30,0,accept
1614,317,165,152,110.0,2.86,36,0,accept
1615,313,165,148,104.0,3.32,30,0,accept
1616,318,167,151,100.0,2.7,0,0,accept
1617,310,160,150,103.0,2.7,0,0,accept
1618,317,164,153,108.0,2.65,0,0,accept
1619,301,158,143,101,2.65,0,0,accept
1620,311,161,150,105.0,2.56,0,0,accept
1621,315,165,150,100.0,3.36,0,0,accept
1622,316,161,155,111.0,2.6,0,0,accept
1623,305,159,146,92.0,1.9,0,0,accept
1624,310,158,152,100.0,1.95,0,0,accept
1625,315,163,152,100.0,2.92,20,0,accept
1626,307,156,151,94.0,2.05,10,0,accept
1627,322,164,158,108.0,3.42,10,0,accept
1628,315,152,163,106.0,2.75,0,0,accept
1629,308,163,145,103.0,2.5,0,0,accept
1630,321,167,154,101.0,2.8,0,0,accept
1631,303,158,145,110.0,2.95,0,0,accept
1632,314,162,152,106.0,2.35,0,0,accept
1633,309,159,150,103.0,2.45,0,0,accept
1634,306,160,146,101.0,3.39,0,0,accept
1635,306,159,147,106.0,2.6,0,0,accept
1636,317,168,149,108.0,2.5,0,0,accept
1637,310,165,145,98.0,2.9,0,3,accept
1638,309,163,146,106.0,2.8,0,0,accept
1639,308,163,145,100.0,3.33,0,0,accept
1640,309,161,148,102.0,3.62,0,0,accept
1641,314,164,150,106.0,3.2,10,3,accept
1642,325,166,159,107.0,2.9,10,0,accept
1643,316,165,151,113.0,2.8,10,0,accept
1644,319,160,159,109.0,2.75,10,3,accept
1645,320,163,157,116.0,3.39,6,0,accept
1646,317,162,155,107.0,2.8,7,3,accept
1647,304,156,148,70.0,2.5,20,0,accept
1648,304,155,149,99.0,2.76,20,0,accept
1649,304,157,147,102.0,3.82,0,0,accept
1650,315,165,150,98.0,1.95,30,3,accept
1651,322,162,160,112.0,2.5,20,3,accept
1652,318,166,152,111.0,3.32,30,0,accept
