gre_score,gre_score_quant,gre_score_verbal,test_score_toefl,undergraduation_score,work_ex,papers_published,university_name,status,ranking
316,164,152,106.0,2.9,9,3,northeastern_university,accept,15
314,163,151,114,3.53,7,3,northeastern_university,accept,15
307,160,147,88.0,3.0,36,0,northeastern_university,accept,15
330,169,161,113.0,2.4,48,3,northeastern_university,accept,15
316,163,153,99.0,2.71,30,0,northeastern_university,accept,15
311,163,148,107.0,3.22,0,0,northeastern_university,accept,15
306,155,151,113.0,3.12,12,0,northeastern_university,accept,15
325,168,157,106.0,2.65,8,3,northeastern_university,accept,15
324,167,157,104.0,3.44,0,0,northeastern_university,accept,15
317,159,158,114.0,3.52,4,1,northeastern_university,accept,15
324,167,157,108.0,3.12,6,2,northeastern_university,accept,15
305,161,144,0,3.28,13,0,northeastern_university,accept,15
324,169,155,112.0,2.88,8,0,northeastern_university,accept,15
318,170,148,102.0,2.8,4,0,northeastern_university,accept,15
312,164,148,65.0,3.68,5,0,northeastern_university,accept,15
319,165,154,99.0,2.87,30,2,northeastern_university,accept,15
306,157,149,100.0,3.56,20,0,northeastern_university,accept,15
304,157,147,95.0,2.82,0,0,northeastern_university,accept,15
306,157,149,111.0,3.55,0,0,northeastern_university,accept,15
332,170,162,115.0,2.75,9,0,northeastern_university,accept,15
317,162,155,101.0,3.46,48,0,northeastern_university,accept,15
309,163,146,102.0,3.1,33,0,northeastern_university,accept,15
320,168,152,99.0,3.3,25,3,northeastern_university,accept,15
305,153,152,107.0,2.75,24,0,northeastern_university,accept,15
323,164,159,110.0,3.12,12,0,northeastern_university,accept,15
318,166,152,104.0,3.47,9,3,northeastern_university,accept,15
327,167,160,115.0,3.19,2,0,northeastern_university,accept,15
320,168,152,107.0,3.52,41,3,northeastern_university,accept,15
324,163,161,110.0,3.64,28,0,northeastern_university,accept,15
311,155,156,101.0,3.13,0,0,northeastern_university,accept,15
318,165,153,112.0,3.66,36,3,northeastern_university,accept,15
315,160,155,106.0,3.76,4,0,northeastern_university,accept,15
321,164,157,104.0,2.88,15,0,northeastern_university,accept,15
317,163,154,112.0,3.4,11,3,northeastern_university,accept,15
332,170,162,114.0,3.28,32,2,northeastern_university,accept,15
316,167,149,103.0,3.45,19,0,northeastern_university,accept,15
313,161,152,106.0,3.33,0,0,northeastern_university,accept,15
315,158,157,100.0,3.0,0,0,northeastern_university,accept,15
316,164,152,98.0,3.26,33,0,northeastern_university,accept,15
319,163,156,112.0,3.4,0,0,northeastern_university,accept,15
318,162,156,108.0,3.8,20,3,northeastern_university,accept,15
322,165,157,118.0,3.56,1,0,northeastern_university,accept,15
312,161,151,108.0,3.33,2,0,northeastern_university,accept,15
320,167,153,107.0,3.5,0,3,northeastern_university,accept,15
318,166,152,110.0,3.14,6,0,northeastern_university,accept,15
320,165,155,108.0,3.46,5,3,northeastern_university,accept,15
318,167,151,108.0,2.94,24,0,northeastern_university,accept,15
320,170,150,107.0,3.68,4,0,northeastern_university,accept,15
315,165,150,114.0,3.8,1,0,northeastern_university,accept,15
308,153,155,75.0,3.21,50,0,northeastern_university,accept,15
310,161,149,100.0,2.92,4,0,northeastern_university,accept,15
338,168,170,119.0,3.68,6,0,northeastern_university,accept,15
315,165,150,105.0,2.59,9,3,northeastern_university,accept,15
313,161,152,114,3.82,1,0,northeastern_university,accept,15
308,156,152,102.0,3.06,7,3,northeastern_university,accept,15
312,162,150,106.0,2.96,0,0,northeastern_university,accept,15
312,163,149,107.0,3.24,25,0,northeastern_university,accept,15
316,163,153,102.0,3.05,6,0,northeastern_university,accept,15
316,165,151,110.0,3.08,9,0,northeastern_university,accept,15
316,164,152,108.0,3.82,3,3,northeastern_university,accept,15
324,169,155,108.0,3.29,30,2,northeastern_university,accept,15
317,161,156,114,2.8,10,0,northeastern_university,accept,15
310,167,143,101,3.19,0,3,northeastern_university,accept,15
329,170,159,108.0,3.38,16,0,northeastern_university,accept,15
310,161,149,106.0,3.14,60,0,northeastern_university,accept,15
316,161,155,101.0,3.5,1,0,northeastern_university,accept,15
316,162,154,100.0,3.46,0,0,northeastern_university,accept,15
317,160,157,111.0,2.61,36,0,northeastern_university,accept,15
321,168,153,109.0,3.27,2,0,northeastern_university,accept,15
318,169,149,100.0,2.89,30,0,northeastern_university,accept,15
311,161,150,102.0,3.66,16,0,northeastern_university,accept,15
319,163,156,113.0,3.44,10,0,northeastern_university,accept,15
325,170,155,110.0,3.44,33,0,northeastern_university,accept,15
320,167,153,104.0,3.46,24,0,northeastern_university,accept,15
320,168,152,101.0,3.44,17,0,northeastern_university,accept,15
327,165,162,109.0,2.87,30,0,northeastern_university,accept,15
314,162,152,104.0,2.96,43,0,northeastern_university,accept,15
319,167,152,110.0,3.14,24,0,northeastern_university,accept,15
326,164,162,110.0,2.96,31,0,northeastern_university,accept,15
327,170,157,109.0,3.33,8,0,northeastern_university,accept,15
320,166,154,102.0,3.42,22,0,northeastern_university,accept,15
314,162,152,105.0,3.47,14,0,northeastern_university,accept,15
306,146,160,101,3.59,60,0,northeastern_university,accept,15
324,170,154,113.0,3.56,31,2,northeastern_university,accept,15
313,164,149,103.0,2.4,27,3,northeastern_university,accept,15
316,164,152,105.0,3.42,24,3,northeastern_university,accept,15
317,165,152,106.0,3.62,0,3,northeastern_university,accept,15
311,163,148,102.0,3.41,28,0,northeastern_university,accept,15
305,160,145,75.0,3.63,6,0,northeastern_university,accept,15
322,155,167,109.0,3.0,20,3,northeastern_university,accept,15
311,160,151,107.0,2.7,60,0,northeastern_university,accept,15
320,165,155,103.0,3.59,4,0,northeastern_university,accept,15
321,167,154,111.0,3.6,6,0,northeastern_university,accept,15
317,166,151,104.0,3.43,6,0,northeastern_university,accept,15
316,164,152,106.0,3.07,28,0,northeastern_university,accept,15
315,164,151,108.0,3.62,1,0,northeastern_university,accept,15
321,163,158,109.0,3.16,44,0,northeastern_university,accept,15
329,166,163,114.0,2.66,18,0,northeastern_university,accept,15
320,170,150,104.0,3.86,2,1,northeastern_university,accept,15
319,163,156,110.0,3.14,60,0,northeastern_university,accept,15
314,162,152,108.0,3.73,2,0,northeastern_university,accept,15
314,166,148,107.0,3.05,18,0,northeastern_university,accept,15
314,160,154,109.0,2.96,24,0,northeastern_university,accept,15
322,168,154,108.0,2.5,7,2,northeastern_university,accept,15
307,158,149,104.0,3.68,1,0,northeastern_university,accept,15
306,157,149,114,3.15,0,3,northeastern_university,accept,15
313,164,149,110.0,2.9,7,0,northeastern_university,accept,15
309,162,147,101,3.8,0,0,northeastern_university,accept,15
317,169,148,75.0,2.88,26,2,northeastern_university,accept,15
315,162,153,109.0,3.89,1,0,northeastern_university,accept,15
318,161,157,114,3.26,33,0,northeastern_university,accept,15
309,160,149,75.0,3.37,30,0,northeastern_university,accept,15
327,168,159,0,3.74,0,0,northeastern_university,accept,15
299,148,151,75.0,2.62,55,0,northeastern_university,accept,15
321,167,154,109.0,3.0,0,0,northeastern_university,accept,15
319,162,157,106.0,3.34,36,0,northeastern_university,accept,15
317,163,154,118.0,3.5,15,2,northeastern_university,accept,15
328,170,158,114.0,2.99,17,0,northeastern_university,accept,15
318,168,150,100.0,3.08,14,0,northeastern_university,accept,15
331,165,166,115.0,2.35,46,0,northeastern_university,accept,15
310,156,154,105.0,3.38,5,3,northeastern_university,accept,15
327,164,163,117.0,3.28,16,0,northeastern_university,accept,15
309,160,149,101,3.5,24,3,northeastern_university,accept,15
317,165,152,114.0,2.64,24,0,northeastern_university,accept,15
313,164,149,75.0,3.57,12,0,northeastern_university,accept,15
314,159,155,111.0,2.7,52,0,northeastern_university,accept,15
321,170,151,100.0,3.36,3,0,northeastern_university,accept,15
318,163,155,109.0,2.4,49,0,northeastern_university,accept,15
318,163,155,114.0,2.94,24,0,northeastern_university,accept,15
315,160,155,75.0,3.01,13,0,northeastern_university,accept,15
313,169,144,100.0,3.07,20,0,northeastern_university,accept,15
317,166,151,102.0,3.5,13,0,northeastern_university,accept,15
312,160,152,107.0,2.96,17,0,northeastern_university,accept,15
326,165,161,100.0,2.84,0,0,northeastern_university,accept,15
320,161,159,113.0,2.7,82,0,northeastern_university,accept,15
316,162,154,107.0,3.19,4,3,northeastern_university,accept,15
322,167,155,108.0,3.16,60,0,northeastern_university,accept,15
325,169,156,112.0,3.38,5,0,northeastern_university,accept,15
318,163,155,108.0,3.32,18,0,northeastern_university,accept,15
318,170,148,101.0,3.25,7,0,northeastern_university,accept,15
308,163,145,75.0,3.1,12,0,northeastern_university,accept,15
313,163,150,101,3.0,18,0,northeastern_university,accept,15
327,164,163,111.0,3.46,22,0,northeastern_university,accept,15
312,163,149,105.0,2.7,22,2,northeastern_university,accept,15
327,170,157,104.0,3.53,18,0,northeastern_university,accept,15
315,161,154,107.0,2.3,36,0,northeastern_university,accept,15
325,159,166,115.0,3.48,1,0,northeastern_university,accept,15
309,164,145,105.0,3.59,2,0,northeastern_university,accept,15
333,168,165,114.0,3.61,2,0,northeastern_university,accept,15
317,162,155,111.0,3.24,1,0,northeastern_university,accept,15
329,166,163,114.0,3.25,3,0,northeastern_university,accept,15
319,168,151,106.0,2.05,38,0,northeastern_university,accept,15
321,163,158,110.0,3.37,6,0,northeastern_university,accept,15
315,164,151,103.0,3.81,32,0,northeastern_university,accept,15
322,166,156,103.0,3.23,28,0,northeastern_university,accept,15
323,170,153,112.0,3.29,12,3,northeastern_university,accept,15
308,158,150,106.0,3.08,0,0,northeastern_university,accept,15
317,164,153,101.0,3.71,50,0,northeastern_university,accept,15
316,165,151,93.0,3.37,52,3,northeastern_university,accept,15
330,167,163,114.0,2.4,6,0,northeastern_university,accept,15
310,159,151,75.0,2.88,58,0,northeastern_university,accept,15
316,163,153,112.0,3.24,24,0,northeastern_university,accept,15
320,162,158,108.0,3.24,28,3,northeastern_university,accept,15
306,158,148,101,2.65,0,0,northeastern_university,accept,15
314,162,152,98.0,3.4,18,2,northeastern_university,accept,15
309,161,148,101.0,2.9,51,0,northeastern_university,accept,15
313,162,151,111.0,3.44,22,3,northeastern_university,accept,15
313,166,147,108.0,3.46,0,0,northeastern_university,accept,15
313,161,152,107.0,3.27,6,2,northeastern_university,accept,15
317,170,147,106.0,3.19,24,0,northeastern_university,accept,15
324,168,156,106.0,3.0,26,0,northeastern_university,accept,15
306,157,149,111.0,3.0,49,0,northeastern_university,accept,15
312,160,152,104.0,3.0,24,0,northeastern_university,accept,15
329,168,161,110.0,3.39,3,2,northeastern_university,accept,15
311,164,147,102.0,3.02,27,3,northeastern_university,accept,15
311,165,146,101,2.2,0,0,northeastern_university,accept,15
317,163,154,105.0,3.29,48,0,northeastern_university,accept,15
310,165,145,101,3.69,15,0,northeastern_university,accept,15
322,163,159,115.0,2.4,22,3,northeastern_university,accept,15
306,159,147,99.0,2.56,29,1,northeastern_university,accept,15
315,162,153,102.0,2.94,31,2,northeastern_university,accept,15
315,163,152,107.0,3.42,0,3,northeastern_university,accept,15
310,165,145,101,2.92,0,0,northeastern_university,accept,15
311,159,152,114,3.34,43,0,northeastern_university,accept,15
318,165,153,102.0,3.57,38,0,northeastern_university,accept,15
323,170,153,107.0,3.66,8,0,northeastern_university,accept,15
312,167,145,99.0,3.3,13,2,northeastern_university,accept,15
307,157,150,104.0,2.62,11,0,northeastern_university,accept,15
326,164,162,110.0,3.24,0,0,northeastern_university,accept,15
307,157,150,107.0,3.4,6,3,northeastern_university,accept,15
324,166,158,112.0,2.18,20,0,northeastern_university,accept,15
316,163,153,0,2.45,27,0,northeastern_university,accept,15
319,164,155,0,3.43,1,3,northeastern_university,accept,15
318,166,152,0,2.93,17,0,northeastern_university,accept,15
314,163,151,106.0,2.74,46,3,northeastern_university,accept,15
321,160,161,111.0,2.8,24,0,northeastern_university,accept,15
328,166,162,0,2.35,24,3,northeastern_university,accept,15
318,167,151,112.0,2.9,2,3,northeastern_university,accept,15
320,161,159,114,2.8,12,1,northeastern_university,accept,15
319,166,153,0,2.5,2,0,northeastern_university,accept,15
315,164,151,108.0,3.18,17,3,northeastern_university,accept,15
314,164,150,108.0,3.48,2,0,northeastern_university,accept,15
322,167,155,107.0,3.28,15,0,northeastern_university,accept,15
315,166,149,105.0,3.68,18,3,northeastern_university,accept,15
314,162,152,105.0,3.4,41,0,northeastern_university,accept,15
320,166,154,104.0,3.62,5,3,northeastern_university,accept,15
329,170,159,116.0,3.64,10,3,northeastern_university,accept,15
312,158,154,104.0,2.96,30,3,northeastern_university,accept,15
321,165,156,105.0,3.0,39,0,northeastern_university,accept,15
332,166,166,115.0,3.52,22,0,northeastern_university,accept,15
329,165,164,113.0,3.16,18,0,northeastern_university,accept,15
324,166,158,120.0,3.75,2,0,northeastern_university,accept,15
317,165,152,102.0,3.09,13,0,northeastern_university,accept,15
330,169,161,116.0,3.43,12,2,northeastern_university,accept,15
304,154,150,105.0,3.2,31,3,northeastern_university,accept,15
320,162,158,102.0,3.32,6,3,northeastern_university,accept,15
325,166,159,113.0,2.76,12,0,northeastern_university,accept,15
319,166,153,112.0,3.42,4,0,northeastern_university,accept,15
326,162,164,111.0,2.76,1,0,northeastern_university,accept,15
309,162,147,105.0,3.32,0,0,northeastern_university,accept,15
320,162,158,117.0,3.37,2,2,northeastern_university,accept,15
319,168,151,0,3.16,14,3,northeastern_university,accept,15
314,161,153,108.0,3.34,17,0,northeastern_university,accept,15
314,162,152,105.0,3.39,4,0,northeastern_university,accept,15
312,154,158,104.0,1.24,2,0,northeastern_university,accept,15
322,162,160,112.0,3.57,12,0,northeastern_university,accept,15
328,163,165,114.0,2.99,69,0,northeastern_university,accept,15
326,167,159,112.0,3.67,5,0,northeastern_university,accept,15
317,165,152,110.0,3.47,0,0,northeastern_university,accept,15
317,166,151,104.0,3.44,2,0,northeastern_university,accept,15
309,157,152,108.0,3.1,26,0,northeastern_university,accept,15
323,168,155,110.0,3.52,5,2,northeastern_university,accept,15
316,162,154,110.0,3.82,16,3,northeastern_university,accept,15
320,165,155,0,2.7,22,3,northeastern_university,accept,15
313,163,150,106.0,3.42,0,1,northeastern_university,accept,15
316,164,152,110.0,3.04,0,0,northeastern_university,accept,15
315,164,151,104.0,2.97,2,0,northeastern_university,accept,15
316,162,154,114,3.38,0,0,northeastern_university,accept,15
321,167,154,113.0,3.54,2,2,northeastern_university,accept,15
321,168,153,106.0,3.4,0,0,northeastern_university,accept,15
334,170,164,117.0,3.28,0,3,northeastern_university,accept,15
318,164,154,0,3.26,16,0,northeastern_university,accept,15
316,159,157,110.0,3.36,36,0,northeastern_university,accept,15
316,164,152,0,3.6,22,3,northeastern_university,accept,15
322,169,153,110.0,3.16,52,0,northeastern_university,accept,15
316,162,154,110.0,3.81,16,3,northeastern_university,accept,15
319,161,158,110.0,3.64,12,0,northeastern_university,accept,15
320,166,154,105.0,3.58,4,3,northeastern_university,accept,15
328,170,158,113.0,3.18,44,0,northeastern_university,accept,15
325,169,156,117.0,3.37,2,3,northeastern_university,accept,15
323,167,156,114.0,2.92,4,0,northeastern_university,accept,15
318,165,153,102.0,2.93,18,2,northeastern_university,accept,15
320,162,158,112.0,3.02,28,0,northeastern_university,accept,15
315,160,155,109.0,3.59,2,3,northeastern_university,accept,15
320,162,158,118.0,2.98,14,0,northeastern_university,accept,15
317,165,152,0,3.34,24,3,northeastern_university,accept,15
316,161,155,113.0,3.17,26,0,northeastern_university,accept,15
322,167,155,112.0,3.17,18,3,northeastern_university,accept,15
316,164,152,103.0,3.1,6,0,northeastern_university,accept,15
324,167,157,111.0,2.85,40,1,northeastern_university,accept,15
316,163,153,104.0,3.05,8,0,northeastern_university,accept,15
315,165,150,102.0,2.46,29,2,northeastern_university,accept,15
308,162,146,104.0,3.07,7,0,northeastern_university,accept,15
303,152,151,100.0,3.0,24,3,northeastern_university,accept,15
319,164,155,115.0,2.95,24,0,northeastern_university,accept,15
310,158,152,107.0,2.88,19,0,northeastern_university,accept,15
319,163,156,114.0,3.05,16,0,northeastern_university,accept,15
334,166,168,114.0,2.46,0,0,northeastern_university,accept,15
319,154,165,102.0,2.25,0,0,northeastern_university,accept,15
314,163,151,109.0,2.82,0,0,northeastern_university,accept,15
311,166,145,98.0,2.15,0,0,northeastern_university,accept,15
299,157,142,97.0,2.22,0,0,northeastern_university,accept,15
302,155,147,109.0,2.9,0,0,northeastern_university,accept,15
310,160,150,95.0,3.13,0,0,northeastern_university,accept,15
312,150,162,104.0,2.1,0,0,northeastern_university,accept,15
309,154,155,104.0,3.26,0,0,northeastern_university,accept,15
320,163,157,108.0,2.92,18,0,northeastern_university,accept,15
321,167,154,110.0,2.88,13,0,northeastern_university,accept,15
318,166,152,113.0,3.19,9,0,northeastern_university,accept,15
323,166,157,113.0,1.42,6,3,northeastern_university,accept,15
314,152,162,112.0,3.24,29,0,northeastern_university,accept,15
322,167,155,112.0,3.26,18,0,northeastern_university,accept,15
316,163,153,108.0,3.33,21,0,northeastern_university,accept,15
316,167,149,105.0,3.24,0,3,northeastern_university,accept,15
319,162,157,105.0,2.9,5,3,northeastern_university,accept,15
313,158,155,103.0,3.32,24,2,northeastern_university,accept,15
314,160,154,108.0,3.32,29,3,northeastern_university,accept,15
318,162,156,101.0,2.55,48,0,northeastern_university,accept,15
311,163,148,101.0,2.92,28,0,northeastern_university,accept,15
320,165,155,106.0,2.9,22,0,northeastern_university,accept,15
304,159,145,102.0,2.75,36,0,northeastern_university,accept,15
327,168,159,114.0,3.37,0,0,northeastern_university,accept,15
316,164,152,106.0,2.73,20,0,northeastern_university,accept,15
323,161,162,114.0,2.81,27,0,northeastern_university,accept,15
310,154,156,103.0,2.34,28,3,northeastern_university,accept,15
313,162,151,102.0,2.92,27,0,northeastern_university,accept,15
306,154,152,102.0,2.91,31,2,northeastern_university,accept,15
309,161,148,101.0,3.04,16,2,northeastern_university,accept,15
313,164,149,101.0,3.44,24,0,northeastern_university,accept,15
313,158,155,103.0,3.32,15,2,northeastern_university,accept,15
311,160,151,110.0,3.72,24,0,northeastern_university,accept,15
314,167,147,100.0,3.68,8,3,northeastern_university,accept,15
316,164,152,109.0,3.34,18,0,northeastern_university,accept,15
318,164,154,101.0,3.47,0,3,northeastern_university,accept,15
319,164,155,111.0,2.8,20,0,northeastern_university,accept,15
320,167,153,104.0,2.8,36,0,northeastern_university,accept,15
317,163,154,113.0,2.56,21,1,northeastern_university,accept,15
316,168,148,113.0,2.85,45,0,northeastern_university,accept,15
316,158,158,119.0,2.99,14,2,northeastern_university,accept,15
317,168,149,100.0,2.95,46,2,northeastern_university,accept,15
319,163,156,104.0,3.04,2,0,northeastern_university,accept,15
319,162,157,105.0,3.52,21,0,northeastern_university,accept,15
316,164,152,102.0,2.92,0,3,northeastern_university,accept,15
325,168,157,112.0,3.3,9,3,northeastern_university,accept,15
311,162,149,104.0,3.51,0,2,northeastern_university,accept,15
313,159,154,112.0,3.0,0,0,northeastern_university,accept,15
316,160,156,102.0,3.15,40,0,northeastern_university,accept,15
319,160,159,117.0,2.83,30,0,northeastern_university,accept,15
312,163,149,101.0,3.01,22,0,northeastern_university,accept,15
329,166,163,113.0,2.86,30,0,northeastern_university,accept,15
308,156,152,99.0,3.04,24,0,northeastern_university,accept,15
312,158,154,109.0,3.22,4,0,northeastern_university,accept,15
310,162,148,99.0,2.85,24,0,northeastern_university,accept,15
314,162,152,99.0,3.15,7,0,northeastern_university,accept,15
319,170,149,107.0,3.18,20,0,northeastern_university,accept,15
317,164,153,99.0,3.59,25,3,northeastern_university,accept,15
314,168,146,103.0,3.52,2,0,northeastern_university,accept,15
312,160,152,108.0,3.6,0,0,northeastern_university,accept,15
313,163,150,99.0,2.95,7,0,northeastern_university,accept,15
315,162,153,108.0,3.16,4,0,northeastern_university,accept,15
313,162,151,110.0,2.67,3,3,northeastern_university,accept,15
320,163,157,115.0,3.04,1,0,northeastern_university,accept,15
320,162,158,104.0,3.1,1,0,northeastern_university,accept,15
315,166,149,107.0,3.76,6,0,northeastern_university,accept,15
318,166,152,112.0,3.29,0,0,northeastern_university,accept,15
314,161,153,107.0,3.13,42,3,northeastern_university,accept,15
309,157,152,101.0,3.24,13,0,northeastern_university,accept,15
322,166,156,102.0,3.48,19,0,northeastern_university,accept,15
314,161,153,111.0,3.75,26,0,northeastern_university,accept,15
324,170,154,98.0,2.36,0,0,northeastern_university,accept,15
311,159,152,103.0,3.08,1,0,northeastern_university,accept,15
315,162,153,108.0,2.58,12,0,northeastern_university,accept,15
318,168,150,106.0,3.55,15,3,northeastern_university,accept,15
315,165,150,100.0,3.33,1,0,northeastern_university,accept,15
316,167,149,106.0,3.4,7,3,northeastern_university,accept,15
320,165,155,108.0,3.15,2,0,northeastern_university,accept,15
310,163,147,100.0,2.45,17,3,northeastern_university,accept,15
314,162,152,105.0,3.56,0,1,northeastern_university,accept,15
325,168,157,110.0,3.08,19,0,northeastern_university,accept,15
316,164,152,101.0,3.66,0,0,northeastern_university,accept,15
315,162,153,109.0,2.7,6,3,northeastern_university,accept,15
322,168,154,111.0,2.92,6,0,northeastern_university,accept,15
310,159,151,101.0,2.4,32,0,northeastern_university,accept,15
313,150,163,103.0,3.35,38,0,northeastern_university,accept,15
309,154,155,104.0,3.28,0,0,northeastern_university,accept,15
315,161,154,110.0,3.26,48,0,northeastern_university,accept,15
309,160,149,101.0,3.05,2,2,northeastern_university,accept,15
317,170,147,105.0,2.8,3,0,northeastern_university,accept,15
307,159,148,111.0,2.74,40,0,northeastern_university,accept,15
313,163,150,110.0,3.73,36,3,northeastern_university,accept,15
314,155,159,105.0,3.39,36,0,northeastern_university,accept,15
317,165,152,108.0,3.07,0,1,northeastern_university,accept,15
317,165,152,107.0,3.1,0,0,northeastern_university,accept,15
315,152,163,105.0,2.1,25,3,northeastern_university,accept,15
315,170,145,108.0,2.9,2,0,northeastern_university,accept,15
315,162,153,100.0,3.3,60,0,northeastern_university,accept,15
326,165,161,112.0,2.55,23,0,northeastern_university,accept,15
317,162,155,110.0,3.17,5,3,northeastern_university,accept,15
315,160,155,104.0,2.35,12,3,northeastern_university,accept,15
319,168,151,106.0,3.49,7,3,northeastern_university,accept,15
315,164,151,110.0,3.3,22,0,northeastern_university,accept,15
309,157,152,103.0,2.8,67,0,northeastern_university,accept,15
320,150,170,107.0,3.28,17,3,northeastern_university,accept,15
324,168,156,110.0,3.36,2,0,northeastern_university,accept,15
319,160,159,107.0,3.48,13,0,northeastern_university,accept,15
310,160,150,99.0,2.55,48,0,northeastern_university,accept,15
303,154,149,109.0,3.0,0,3,northeastern_university,accept,15
309,158,151,102.0,3.22,17,0,northeastern_university,accept,15
321,167,154,112.0,3.24,12,0,northeastern_university,accept,15
318,163,155,101.0,2.88,4,3,northeastern_university,accept,15
310,161,149,103.0,2.38,24,0,northeastern_university,accept,15
307,159,148,99.0,2.73,15,0,northeastern_university,accept,15
309,163,146,104.0,2.64,32,0,northeastern_university,accept,15
320,167,153,103.0,3.38,40,0,northeastern_university,accept,15
329,167,162,117.0,3.47,2,0,northeastern_university,accept,15
317,164,153,107.0,2.81,20,0,northeastern_university,accept,15
317,165,152,111.0,3.79,24,0,northeastern_university,accept,15
312,162,150,109.0,2.65,36,0,northeastern_university,accept,15
318,167,151,111.0,2.48,35,0,northeastern_university,accept,15
321,166,155,117.0,3.48,0,0,northeastern_university,accept,15
307,155,152,75.0,2.98,27,0,northeastern_university,accept,15
311,160,151,109.0,3.07,0,0,northeastern_university,accept,15
324,168,156,107.0,3.27,7,0,northeastern_university,accept,15
317,168,149,102.0,3.26,1,0,northeastern_university,accept,15
316,167,149,109.0,3.09,0,2,northeastern_university,accept,15
313,167,146,111.0,2.76,30,1,northeastern_university,accept,15
300,151,149,102.0,2.4,42,0,northeastern_university,accept,15
311,162,149,100.0,2.69,30,1,northeastern_university,accept,15
319,165,154,109.0,3.16,5,0,northeastern_university,accept,15
311,167,144,101,3.02,12,0,northeastern_university,accept,15
312,157,155,109.0,2.8,30,0,northeastern_university,accept,15
306,163,143,101,3.3,19,0,northeastern_university,accept,15
305,160,145,107.0,3.24,14,0,northeastern_university,accept,15
316,166,150,106.0,3.2,15,3,northeastern_university,accept,15
309,163,146,101,3.15,25,0,northeastern_university,accept,15
319,162,157,108.0,2.68,0,0,northeastern_university,accept,15
306,157,149,101,1.38,1,0,northeastern_university,accept,15
310,162,148,102.0,2.59,30,1,northeastern_university,accept,15
312,159,153,102.0,2.3,0,0,northeastern_university,accept,15
307,158,149,105.0,2.96,48,1,northeastern_university,accept,15
307,158,149,107.0,3.06,22,0,northeastern_university,accept,15
314,162,152,107.0,2.4,9,0,northeastern_university,accept,15
313,167,146,100.0,2.97,13,0,northeastern_university,accept,15
329,166,163,102.0,2.86,30,0,northeastern_university,accept,15
300,151,149,105.0,2.9,42,0,northeastern_university,accept,15
313,166,147,106.0,2.7,0,2,northeastern_university,accept,15
312,161,151,109.0,3.04,4,0,northeastern_university,accept,15
317,164,153,112.0,3.28,0,3,northeastern_university,accept,15
314,163,151,106.0,2.3,24,0,northeastern_university,accept,15
312,163,149,101.0,2.95,21,0,northeastern_university,accept,15
312,160,152,109.0,2.65,9,0,northeastern_university,accept,15
306,158,148,98.0,2.5,3,3,northeastern_university,accept,15
313,165,148,101.0,2.56,50,0,northeastern_university,accept,15
322,170,152,110.0,2.67,24,3,northeastern_university,accept,15
319,161,158,118.0,2.33,0,0,northeastern_university,accept,15
309,158,151,75.0,3.27,11,0,northeastern_university,accept,15
309,165,144,75.0,3.54,0,0,northeastern_university,accept,15
314,159,155,109.0,2.95,40,0,northeastern_university,accept,15
312,165,147,107.0,3.47,31,0,northeastern_university,accept,15
318,167,151,103.0,3.38,18,3,northeastern_university,accept,15
326,165,161,115.0,2.71,0,3,northeastern_university,accept,15
315,156,159,110.0,2.95,0,0,northeastern_university,accept,15
305,158,147,99.0,2.84,0,3,northeastern_university,accept,15
321,167,154,108.0,3.44,2,0,northeastern_university,accept,15
320,167,153,101.0,2.89,0,0,northeastern_university,accept,15
322,170,152,110.0,3.48,0,0,northeastern_university,accept,15
315,164,151,105.0,3.16,9,0,northeastern_university,accept,15
317,167,150,99.0,2.6,9,3,northeastern_university,accept,15
317,165,152,101.0,2.3,0,0,northeastern_university,accept,15
309,160,149,100.0,2.4,30,2,northeastern_university,accept,15
312,162,150,104.0,3.44,20,3,northeastern_university,accept,15
310,157,153,104.0,3.3,30,0,northeastern_university,accept,15
319,166,153,113.0,2.64,24,0,northeastern_university,accept,15
314,164,150,108.0,3.38,3,3,northeastern_university,accept,15
319,170,149,102.0,3.24,33,0,northeastern_university,accept,15
289,147,142,92.0,2.3,60,0,northeastern_university,accept,15
309,157,152,98.0,3.61,28,0,northeastern_university,accept,15
305,162,143,103.0,3.6,4,3,northeastern_university,accept,15
315,162,153,104.0,3.48,24,0,northeastern_university,accept,15
322,170,152,111.0,3.15,22,0,northeastern_university,accept,15
298,152,146,101,2.25,10,0,northeastern_university,accept,15
324,170,154,105.0,3.31,10,0,northeastern_university,accept,15
331,167,164,112.0,2.62,32,3,northeastern_university,accept,15
319,164,155,103.0,2.45,9,0,northeastern_university,accept,15
314,162,152,108.0,2.6,30,0,northeastern_university,accept,15
320,170,150,104.0,2.65,0,0,northeastern_university,accept,15
324,170,154,101.0,3.08,24,3,northeastern_university,accept,15
313,165,148,103.0,3.16,10,3,northeastern_university,accept,15
315,167,148,99.0,2.8,0,3,northeastern_university,accept,15
322,166,156,113.0,3.0,30,3,northeastern_university,accept,15
318,164,154,101.0,2.73,40,0,northeastern_university,accept,15
313,160,153,111.0,3.1,36,0,northeastern_university,accept,15
311,162,149,108.0,3.34,0,0,northeastern_university,accept,15
317,165,152,101,3.2,10,0,northeastern_university,accept,15
316,164,152,101.0,3.56,36,0,northeastern_university,accept,15
320,165,155,105.0,2.3,39,1,northeastern_university,accept,15
311,161,150,103.0,3.03,10,3,northeastern_university,accept,15
316,166,150,108.0,3.24,24,3,northeastern_university,accept,15
317,164,153,104.0,2.9,28,0,northeastern_university,accept,15
326,168,158,110.0,3.24,0,2,northeastern_university,accept,15
316,170,146,105.0,3.08,36,3,northeastern_university,accept,15
323,165,158,112.0,3.4,60,0,northeastern_university,accept,15
302,156,146,100.0,2.23,30,0,northeastern_university,accept,15
316,167,149,100.0,3.28,0,1,northeastern_university,accept,15
312,160,152,102.0,3.0,16,0,northeastern_university,accept,15
305,159,146,102.0,2.75,0,3,northeastern_university,accept,15
313,163,150,93.0,3.13,12,0,northeastern_university,accept,15
323,167,156,107.0,2.45,22,3,northeastern_university,accept,15
315,153,162,102.0,2.86,48,3,northeastern_university,accept,15
321,169,152,113.0,2.75,1,3,northeastern_university,accept,15
310,166,144,101,3.15,20,0,northeastern_university,accept,15
306,160,146,100.0,3.2,30,3,northeastern_university,accept,15
311,167,144,100.0,3.08,7,0,northeastern_university,accept,15
307,161,146,102.0,3.64,30,0,northeastern_university,accept,15
317,165,152,107.0,3.65,0,3,northeastern_university,accept,15
320,168,152,102.0,3.2,30,0,northeastern_university,accept,15
316,161,155,108.0,3.51,0,0,northeastern_university,accept,15
323,166,157,117.0,3.68,10,3,northeastern_university,accept,15
319,167,152,113.0,3.66,2,3,northeastern_university,accept,15
323,166,157,117.0,3.68,0,3,northeastern_university,accept,15
320,166,154,114.0,3.0,10,2,northeastern_university,accept,15
306,163,143,98.0,2.25,30,0,northeastern_university,accept,15
322,167,155,104.0,3.2,10,0,northeastern_university,accept,15
323,170,153,106.0,2.8,18,0,northeastern_university,accept,15
324,170,154,102.0,2.53,0,1,northeastern_university,accept,15
318,160,158,112.0,3.14,0,0,northeastern_university,accept,15
312,161,151,108.0,3.42,0,0,northeastern_university,accept,15
309,159,150,100.0,2.75,30,3,northeastern_university,accept,15
309,159,150,103.0,3.1,0,1,northeastern_university,accept,15
326,168,158,108.0,3.45,30,0,northeastern_university,accept,15
317,168,149,104.0,3.05,20,2,northeastern_university,accept,15
317,162,155,110.0,2.6,0,0,northeastern_university,accept,15
320,164,156,113.0,2.75,0,0,northeastern_university,accept,15
316,164,152,104.0,2.6,30,3,northeastern_university,accept,15
326,162,164,117.0,3.2,20,3,northeastern_university,accept,15
310,165,145,101.0,3.01,6,2,northeastern_university,accept,15
314,164,150,100.0,2.35,0,1,northeastern_university,accept,15
307,161,146,101,2.29,0,0,northeastern_university,accept,15
308,164,144,100.0,2.75,0,0,northeastern_university,accept,15
311,161,150,106.0,2.4,20,0,northeastern_university,accept,15
314,165,149,100.0,2.9,0,2,northeastern_university,accept,15
315,162,153,110.0,3.15,0,0,northeastern_university,accept,15
322,164,158,113.0,2.68,0,0,northeastern_university,accept,15
311,162,149,111.0,3.02,20,0,northeastern_university,accept,15
318,163,155,108.0,2.55,10,0,northeastern_university,accept,15
327,164,163,117.0,2.6,20,0,northeastern_university,accept,15
306,156,150,113.0,2.59,0,0,northeastern_university,accept,15
314,163,151,109.0,3.64,30,0,northeastern_university,accept,15
314,158,156,106.0,3.58,30,2,northeastern_university,accept,15
308,159,149,108.0,2.97,20,0,northeastern_university,accept,15
317,162,155,111.0,2.6,10,0,northeastern_university,accept,15
322,167,155,106.0,2.7,0,0,northeastern_university,accept,15
316,161,155,102.0,2.6,20,2,northeastern_university,accept,15
314,158,156,107.0,3.35,20,0,northeastern_university,accept,15
315,163,152,110.0,2.85,30,3,northeastern_university,accept,15
313,161,152,114,3.24,30,3,northeastern_university,accept,15
308,157,151,99.0,3.23,30,0,northeastern_university,accept,15
304,155,149,106.0,3.41,27,0,northeastern_university,accept,15
317,165,152,103.0,3.68,30,0,northeastern_university,accept,15
309,155,154,106.0,2.61,30,0,northeastern_university,accept,15
324,162,162,85.0,3.18,30,0,northeastern_university,accept,15
309,157,152,103.0,3.4,30,0,northeastern_university,accept,15
316,165,151,96.0,1.97,30,0,northeastern_university,accept,15
312,163,149,101.0,3.02,30,0,northeastern_university,accept,15
313,164,149,105.0,3.22,30,0,northeastern_university,accept,15
317,165,152,110.0,2.86,36,0,northeastern_university,accept,15
313,165,148,104.0,3.32,30,0,northeastern_university,accept,15
318,167,151,100.0,2.7,0,0,northeastern_university,accept,15
310,160,150,103.0,2.7,0,0,northeastern_university,accept,15
317,164,153,108.0,2.65,0,0,northeastern_university,accept,15
301,158,143,101,2.65,0,0,northeastern_university,accept,15
311,161,150,105.0,2.56,0,0,northeastern_university,accept,15
315,165,150,100.0,3.36,0,0,northeastern_university,accept,15
316,161,155,111.0,2.6,0,0,northeastern_university,accept,15
305,159,146,92.0,1.9,0,0,northeastern_university,accept,15
310,158,152,100.0,1.95,0,0,northeastern_university,accept,15
315,163,152,100.0,2.92,20,0,northeastern_university,accept,15
307,156,151,94.0,2.05,10,0,northeastern_university,accept,15
322,164,158,108.0,3.42,10,0,northeastern_university,accept,15
315,152,163,106.0,2.75,0,0,northeastern_university,accept,15
308,163,145,103.0,2.5,0,0,northeastern_university,accept,15
321,167,154,101.0,2.8,0,0,northeastern_university,accept,15
303,158,145,110.0,2.95,0,0,northeastern_university,accept,15
314,162,152,106.0,2.35,0,0,northeastern_university,accept,15
309,159,150,103.0,2.45,0,0,northeastern_university,accept,15
306,160,146,101.0,3.39,0,0,northeastern_university,accept,15
306,159,147,106.0,2.6,0,0,northeastern_university,accept,15
317,168,149,108.0,2.5,0,0,northeastern_university,accept,15
310,165,145,98.0,2.9,0,3,northeastern_university,accept,15
309,163,146,106.0,2.8,0,0,northeastern_university,accept,15
308,163,145,100.0,3.33,0,0,northeastern_university,accept,15
309,161,148,102.0,3.62,0,0,northeastern_university,accept,15
314,164,150,106.0,3.2,10,3,northeastern_university,accept,15
325,166,159,107.0,2.9,10,0,northeastern_university,accept,15
316,165,151,113.0,2.8,10,0,northeastern_university,accept,15
319,160,159,109.0,2.75,10,3,northeastern_university,accept,15
320,163,157,116.0,3.39,6,0,northeastern_university,accept,15
317,162,155,107.0,2.8,7,3,northeastern_university,accept,15
304,156,148,70.0,2.5,20,0,northeastern_university,accept,15
304,155,149,99.0,2.76,20,0,northeastern_university,accept,15
304,157,147,102.0,3.82,0,0,northeastern_university,accept,15
315,165,150,98.0,1.95,30,3,northeastern_university,accept,15
322,162,160,112.0,2.5,20,3,northeastern_university,accept,15
318,166,152,111.0,3.32,30,0,northeastern_university,accept,15
328,167,161,117.0,3.28,16,0,carnegie_mellon_university,reject,1
328,167,161,117.0,3.28,16,0,carnegie_mellon_university,reject,1
327,169,158,108.0,3.52,2,3,carnegie_mellon_university,reject,1
320,168,152,101.0,2.96,4,0,carnegie_mellon_university,reject,1
320,165,155,118.0,3.52,12,0,carnegie_mellon_university,reject,1
325,167,158,108.0,3.62,23,3,carnegie_mellon_university,reject,1
331,169,162,115.0,3.3,19,3,carnegie_mellon_university,reject,1
308,164,144,96.0,2.64,4,0,carnegie_mellon_university,reject,1
316,163,153,111.0,3.64,14,0,carnegie_mellon_university,reject,1
325,165,160,114.0,3.75,9,0,carnegie_mellon_university,reject,1
322,170,152,110.0,3.65,22,0,carnegie_mellon_university,reject,1
316,162,154,107.0,3.19,4,3,carnegie_mellon_university,reject,1
323,168,155,116.0,3.44,20,0,carnegie_mellon_university,reject,1
325,170,155,104.0,3.63,0,3,carnegie_mellon_university,reject,1
325,170,155,115.0,3.45,11,0,carnegie_mellon_university,reject,1
330,170,160,111.0,3.23,0,0,carnegie_mellon_university,reject,1
328,167,161,117.0,3.28,16,0,carnegie_mellon_university,reject,1
328,167,161,117.0,3.28,16,0,carnegie_mellon_university,reject,1
320,168,152,101.0,2.96,4,0,carnegie_mellon_university,reject,1
320,165,155,118.0,3.52,12,0,carnegie_mellon_university,reject,1
325,167,158,108.0,3.62,23,3,carnegie_mellon_university,reject,1
327,169,158,108.0,3.63,0,3,carnegie_mellon_university,reject,1
308,164,144,96.0,2.64,4,0,carnegie_mellon_university,reject,1
316,163,153,111.0,3.64,14,0,carnegie_mellon_university,reject,1
325,165,160,114.0,3.75,9,0,carnegie_mellon_university,reject,1
316,162,154,107.0,3.19,4,3,carnegie_mellon_university,reject,1
323,168,155,116.0,3.44,20,0,carnegie_mellon_university,reject,1
325,170,155,104.0,3.63,0,3,carnegie_mellon_university,reject,1
323,166,157,106.0,3.64,19,0,carnegie_mellon_university,reject,1
330,170,160,111.0,3.23,0,0,carnegie_mellon_university,reject,1
321,168,153,117.0,3.66,14,3,carnegie_mellon_university,reject,1
323,166,157,112.0,3.54,18,3,carnegie_mellon_university,reject,1
318,169,149,103.0,3.5,18,0,carnegie_mellon_university,reject,1
330,169,161,112.0,3.5,18,0,carnegie_mellon_university,reject,1
327,168,159,0,3.74,0,0,carnegie_mellon_university,reject,1
318,167,151,109.0,3.88,2,0,carnegie_mellon_university,reject,1
324,169,155,115.0,3.33,19,0,carnegie_mellon_university,reject,1
323,168,155,117.0,3.82,5,0,carnegie_mellon_university,reject,1
323,169,154,109.0,3.83,4,2,carnegie_mellon_university,reject,1
333,170,163,118.0,3.42,14,3,carnegie_mellon_university,reject,1
321,170,151,113.0,3.2,9,3,carnegie_mellon_university,reject,1
320,169,151,105.0,3.88,2,0,carnegie_mellon_university,reject,1
318,165,153,107.0,3.61,29,3,carnegie_mellon_university,reject,1
325,168,157,116.0,3.46,2,0,carnegie_mellon_university,reject,1
322,170,152,107.0,3.08,8,0,carnegie_mellon_university,reject,1
316,166,150,103.0,3.56,8,3,carnegie_mellon_university,reject,1
325,167,158,114.0,3.48,1,0,carnegie_mellon_university,reject,1
319,166,153,103.0,2.86,40,0,carnegie_mellon_university,reject,1
321,161,160,118.0,3.12,1,2,carnegie_mellon_university,reject,1
319,163,156,115.0,3.2,1,2,carnegie_mellon_university,reject,1
322,166,156,104.0,3.56,10,3,carnegie_mellon_university,reject,1
325,167,158,114.0,3.48,10,0,carnegie_mellon_university,reject,1
324,167,157,108.0,3.12,6,2,carnegie_mellon_university,reject,1
324,165,159,111.0,3.54,1,3,carnegie_mellon_university,reject,1
319,170,149,105.0,3.36,22,3,carnegie_mellon_university,reject,1
325,166,159,110.0,3.74,22,0,carnegie_mellon_university,reject,1
320,166,154,106.0,2.67,23,3,carnegie_mellon_university,reject,1
318,166,152,103.0,3.14,17,0,carnegie_mellon_university,reject,1
324,166,158,116.0,3.68,35,0,carnegie_mellon_university,reject,1
320,165,155,112.0,2.72,1,0,carnegie_mellon_university,reject,1
321,167,154,113.0,3.44,0,0,carnegie_mellon_university,reject,1
322,169,153,111.0,2.98,18,3,carnegie_mellon_university,reject,1
327,165,162,112.0,3.56,4,0,carnegie_mellon_university,reject,1
325,170,155,106.0,3.71,2,0,carnegie_mellon_university,reject,1
325,170,155,106.0,3.71,2,0,carnegie_mellon_university,reject,1
335,170,165,117.0,3.2,29,0,carnegie_mellon_university,reject,1
327,167,160,109.0,2.88,24,0,carnegie_mellon_university,reject,1
323,170,153,113.0,3.28,2,3,carnegie_mellon_university,reject,1
322,170,152,111.0,3.82,30,3,carnegie_mellon_university,reject,1
324,170,154,115.0,3.63,12,0,carnegie_mellon_university,reject,1
303,160,143,114,3.32,9,0,carnegie_mellon_university,reject,1
323,168,155,108.0,2.64,6,3,carnegie_mellon_university,reject,1
324,168,156,115.0,3.82,20,0,carnegie_mellon_university,reject,1
321,167,154,113.0,3.66,2,0,carnegie_mellon_university,reject,1
332,168,164,115.0,3.17,17,3,carnegie_mellon_university,reject,1
332,170,162,117.0,3.78,0,0,carnegie_mellon_university,reject,1
317,164,153,110.0,3.24,18,3,carnegie_mellon_university,reject,1
329,170,159,116.0,3.42,6,3,carnegie_mellon_university,reject,1
280,140,140,108.0,3.0,11,3,carnegie_mellon_university,reject,1
328,170,158,114.0,2.99,17,0,carnegie_mellon_university,reject,1
319,168,151,75.0,3.31,15,0,carnegie_mellon_university,reject,1
319,168,151,75.0,3.31,15,0,carnegie_mellon_university,reject,1
315,163,152,102.0,3.1,8,0,carnegie_mellon_university,reject,1
325,167,158,110.0,3.66,5,3,carnegie_mellon_university,reject,1
322,169,153,114.0,2.85,8,3,carnegie_mellon_university,reject,1
302,160,142,102.0,3.82,30,3,carnegie_mellon_university,reject,1
323,170,153,108.0,3.53,15,3,carnegie_mellon_university,reject,1
330,170,160,117.0,3.69,0,0,carnegie_mellon_university,reject,1
319,164,155,115.0,1.43,0,0,carnegie_mellon_university,reject,1
332,170,162,117.0,3.62,1,3,carnegie_mellon_university,reject,1
321,166,155,109.0,3.64,1,3,carnegie_mellon_university,reject,1
333,170,163,111.0,3.81,22,0,carnegie_mellon_university,reject,1
324,169,155,116.0,3.42,26,3,carnegie_mellon_university,reject,1
315,165,150,104.0,2.95,26,0,carnegie_mellon_university,reject,1
320,165,155,117.0,2.9,0,0,carnegie_mellon_university,reject,1
335,168,167,0,3.89,3,3,carnegie_mellon_university,reject,1
331,169,162,118.0,3.81,0,3,carnegie_mellon_university,reject,1
323,166,157,114.0,3.64,20,3,carnegie_mellon_university,reject,1
322,168,154,104.0,3.36,50,0,carnegie_mellon_university,reject,1
329,170,159,117.0,3.58,3,2,carnegie_mellon_university,reject,1
325,170,155,106.0,3.51,14,0,carnegie_mellon_university,reject,1
320,167,153,100.0,3.82,36,0,carnegie_mellon_university,reject,1
327,170,157,108.0,3.46,24,0,carnegie_mellon_university,reject,1
320,166,154,113.0,3.64,0,3,carnegie_mellon_university,reject,1
322,162,160,113.0,3.5,9,0,carnegie_mellon_university,reject,1
321,167,154,108.0,3.05,27,0,carnegie_mellon_university,reject,1
320,162,158,117.0,3.37,2,2,carnegie_mellon_university,reject,1
330,170,160,0,3.93,34,3,carnegie_mellon_university,reject,1
309,166,143,101.0,3.24,14,0,carnegie_mellon_university,reject,1
331,170,161,112.0,3.2,28,0,carnegie_mellon_university,reject,1
331,170,161,112.0,3.2,28,0,carnegie_mellon_university,reject,1
317,166,151,104.0,3.24,18,3,carnegie_mellon_university,reject,1
330,168,162,0,3.12,18,0,carnegie_mellon_university,reject,1
324,167,157,116.0,3.41,6,3,carnegie_mellon_university,reject,1
326,169,157,110.0,1.41,0,3,carnegie_mellon_university,reject,1
314,167,147,0,3.37,29,0,carnegie_mellon_university,reject,1
329,167,162,110.0,2.96,4,0,carnegie_mellon_university,reject,1
321,167,154,112.0,3.44,37,0,carnegie_mellon_university,reject,1
323,167,156,110.0,3.0,29,0,carnegie_mellon_university,reject,1
320,170,150,105.0,3.5,26,0,carnegie_mellon_university,reject,1
304,156,148,102.0,3.05,42,0,carnegie_mellon_university,reject,1
320,168,152,102.0,3.49,7,3,carnegie_mellon_university,reject,1
325,167,158,103.0,3.44,15,0,carnegie_mellon_university,reject,1
326,167,159,112.0,3.67,5,0,carnegie_mellon_university,reject,1
325,167,158,110.0,3.85,5,3,carnegie_mellon_university,reject,1
326,167,159,100.0,3.47,50,0,carnegie_mellon_university,accept,1
336,170,166,119.0,2.69,18,0,carnegie_mellon_university,accept,1
326,169,157,111.0,3.74,14,3,carnegie_mellon_university,accept,1
280,140,140,90.0,3.43,0,0,carnegie_mellon_university,accept,1
338,170,168,0,3.46,15,3,carnegie_mellon_university,accept,1
323,168,155,115.0,3.69,5,3,carnegie_mellon_university,accept,1
325,168,157,119.0,3.8,4,0,carnegie_mellon_university,accept,1
328,170,158,109.0,3.89,0,3,carnegie_mellon_university,accept,1
331,168,163,116.0,3.7,4,0,carnegie_mellon_university,accept,1
328,170,158,107.0,3.3,2,3,carnegie_mellon_university,accept,1
318,167,151,108.0,3.43,24,3,carnegie_mellon_university,accept,1
325,168,157,113.0,3.25,6,3,carnegie_mellon_university,accept,1
326,167,159,100.0,3.47,50,0,carnegie_mellon_university,accept,1
336,168,168,112.0,3.96,0,2,carnegie_mellon_university,accept,1
336,170,166,119.0,2.69,18,0,carnegie_mellon_university,accept,1
326,169,157,111.0,3.74,14,3,carnegie_mellon_university,accept,1
330,168,162,109.0,3.78,5,3,carnegie_mellon_university,accept,1
330,168,162,109.0,3.78,5,3,carnegie_mellon_university,accept,1
322,164,158,112.0,3.7,12,0,carnegie_mellon_university,accept,1
325,170,155,110.0,3.56,40,0,carnegie_mellon_university,accept,1
320,160,160,100.0,3.45,12,1,carnegie_mellon_university,accept,1
319,162,157,113.0,3.2,30,3,carnegie_mellon_university,accept,1
322,163,159,114.0,3.31,10,0,carnegie_mellon_university,accept,1
321,167,154,108.0,2.35,10,0,carnegie_mellon_university,accept,1
329,165,164,118.0,3.34,10,0,carnegie_mellon_university,accept,1
315,162,153,116.0,2.95,20,3,carnegie_mellon_university,accept,1
329,166,163,114.0,3.0,10,0,carnegie_mellon_university,accept,1
323,164,159,116.0,2.85,0,3,carnegie_mellon_university,accept,1
322,170,152,112.0,3.78,30,0,carnegie_mellon_university,accept,1
325,168,157,110.0,3.64,10,0,carnegie_mellon_university,accept,1
315,167,148,109.0,2.3,0,0,carnegie_mellon_university,accept,1
315,163,152,108.0,3.5,30,0,carnegie_mellon_university,accept,1
325,166,159,113.0,3.6,20,3,carnegie_mellon_university,accept,1
325,166,159,113.0,3.6,20,3,carnegie_mellon_university,accept,1
320,158,162,114.0,3.6,10,1,carnegie_mellon_university,accept,1
319,161,158,110.0,3.5,10,2,carnegie_mellon_university,accept,1
331,170,161,118.0,3.54,20,0,carnegie_mellon_university,accept,1
292,153,139,84.0,2.1,3,0,clemson_university,accept,89
292,153,139,84.0,2.1,3,0,clemson_university,accept,89
306,157,149,101,3.2,27,0,clemson_university,accept,89
304,157,147,95.0,2.82,0,0,clemson_university,accept,89
299,155,144,88.0,2.8,0,3,clemson_university,accept,89
316,162,154,107.0,2.35,36,3,clemson_university,accept,89
311,167,144,87.0,3.36,0,0,clemson_university,accept,89
296,156,140,82.0,3.08,6,0,clemson_university,accept,89
326,169,157,114,3.59,0,0,clemson_university,accept,89
306,156,150,106.0,3.5,1,2,clemson_university,accept,89
310,160,150,106.0,2.87,24,0,clemson_university,accept,89
312,161,151,110.0,3.15,0,0,clemson_university,accept,89
305,160,145,98.0,2.68,1,3,clemson_university,accept,89
313,161,152,90.0,2.4,26,0,clemson_university,accept,89
303,156,147,100.0,2.76,53,2,clemson_university,accept,89
313,160,153,103.0,3.09,19,0,clemson_university,accept,89
307,158,149,89.0,2.65,13,0,clemson_university,accept,89
321,162,159,106.0,3.16,39,0,clemson_university,accept,89
312,163,149,105.0,2.7,22,2,clemson_university,accept,89
312,160,152,104.0,2.96,32,3,clemson_university,accept,89
306,156,150,87.0,2.34,16,3,clemson_university,accept,89
301,160,141,65.0,3.65,14,0,clemson_university,accept,89
301,160,141,65.0,3.65,14,0,clemson_university,accept,89
298,155,143,90.0,3.16,0,0,clemson_university,accept,89
309,160,149,99.0,3.4,1,0,clemson_university,accept,89
322,163,159,106.0,2.71,2,2,clemson_university,accept,89
324,169,155,108.0,3.29,30,2,clemson_university,accept,89
305,156,149,88.0,3.35,25,0,clemson_university,accept,89
307,159,148,90.0,3.53,9,0,clemson_university,accept,89
310,160,150,100.0,3.1,36,2,clemson_university,accept,89
307,165,142,65.0,2.6,14,0,clemson_university,accept,89
299,154,145,94.0,2.48,52,0,clemson_university,accept,89
312,159,153,101.0,3.34,16,0,clemson_university,accept,89
311,163,148,65.0,2.58,0,0,clemson_university,accept,89
308,163,145,95.0,3.09,30,0,clemson_university,accept,89
311,163,148,65.0,2.58,0,0,clemson_university,accept,89
308,163,145,95.0,3.09,30,0,clemson_university,accept,89
305,156,149,92.0,3.25,0,0,clemson_university,accept,89
312,163,149,87.0,2.81,30,1,clemson_university,accept,89
305,156,149,100.0,3.77,18,3,clemson_university,accept,89
306,160,146,90.0,2.89,35,0,clemson_university,accept,89
314,165,149,0,2.95,6,0,clemson_university,accept,89
314,165,149,0,2.95,6,0,clemson_university,accept,89
305,159,146,96.0,2.8,0,0,clemson_university,accept,89
303,154,149,103.0,2.4,28,1,clemson_university,accept,89
329,168,161,118.0,2.64,19,3,clemson_university,accept,89
313,165,148,91.0,3.06,28,0,clemson_university,accept,89
313,162,151,106.0,3.15,23,0,clemson_university,accept,89
307,163,144,95.0,2.94,30,0,clemson_university,accept,89
315,164,151,96.0,3.0,26,1,clemson_university,accept,89
304,152,152,95.0,2.3,0,0,clemson_university,accept,89
311,168,143,65.0,2.83,6,0,clemson_university,accept,89
309,159,150,104.0,2.6,26,0,clemson_university,accept,89
320,163,157,102.0,2.75,31,0,clemson_university,accept,89
306,159,147,96.0,2.61,44,0,clemson_university,accept,89
302,155,147,96.0,3.04,1,0,clemson_university,accept,89
303,163,140,81.0,2.77,8,0,clemson_university,accept,89
318,159,159,113.0,3.08,10,0,clemson_university,accept,89
313,165,148,75.0,3.09,0,0,clemson_university,accept,89
309,160,149,107.0,3.76,2,0,clemson_university,accept,89
298,157,141,90.0,2.5,28,0,clemson_university,accept,89
305,160,145,114,3.2,2,0,clemson_university,accept,89
305,160,145,114,3.2,2,0,clemson_university,accept,89
309,158,151,100.0,3.12,7,0,clemson_university,accept,89
320,168,152,108.0,2.69,7,3,clemson_university,accept,89
305,156,149,105.0,2.6,14,0,clemson_university,accept,89
310,161,149,93.0,3.28,0,0,clemson_university,accept,89
306,161,145,100.0,3.26,0,3,clemson_university,accept,89
333,170,163,0,2.5,13,0,clemson_university,accept,89
303,156,147,87.0,3.25,30,0,clemson_university,accept,89
300,158,142,95.0,3.02,27,0,clemson_university,accept,89
305,156,149,92.0,3.25,4,0,clemson_university,accept,89
299,152,147,65.0,2.95,0,3,clemson_university,accept,89
310,160,150,98.0,3.25,1,0,clemson_university,accept,89
302,158,144,98.0,3.4,0,3,clemson_university,accept,89
307,158,149,95.0,2.82,18,0,clemson_university,accept,89
312,160,152,106.0,2.4,6,0,clemson_university,accept,89
312,163,149,99.0,3.3,6,0,clemson_university,accept,89
307,160,147,101,3.28,23,0,clemson_university,accept,89
311,156,155,113.0,2.5,0,2,clemson_university,accept,89
311,159,152,103.0,3.08,1,0,clemson_university,accept,89
308,161,147,93.0,3.23,12,0,clemson_university,accept,89
300,160,140,65.0,2.71,0,0,clemson_university,reject,89
300,160,140,65.0,2.71,0,0,clemson_university,reject,89
315,168,147,75.0,3.2,34,0,clemson_university,reject,89
313,166,147,0,1.99,29,0,clemson_university,reject,89
316,165,151,96.0,2.72,45,0,clemson_university,reject,89
303,160,143,90.0,2.75,25,0,clemson_university,reject,89
310,155,155,111.0,2.96,15,0,clemson_university,reject,89
307,159,148,99.0,2.94,4,3,clemson_university,reject,89
305,163,142,101,3.2,2,3,clemson_university,reject,89
310,158,152,107.0,2.48,13,0,clemson_university,reject,89
306,163,143,101.0,2.38,45,0,clemson_university,reject,89
309,161,148,98.0,1.06,2,0,clemson_university,reject,89
316,169,147,96.0,3.05,0,0,clemson_university,reject,89
312,164,148,98.0,2.91,5,0,clemson_university,reject,89
313,166,147,105.0,1.52,6,3,clemson_university,reject,89
313,166,147,91.0,2.64,32,0,clemson_university,reject,89
311,151,160,110.0,2.6,7,3,clemson_university,reject,89
311,161,150,99.0,3.21,0,0,clemson_university,reject,89
303,157,146,97.0,3.17,21,0,clemson_university,reject,89
307,162,145,101,3.08,33,0,clemson_university,reject,89
306,158,148,93.0,2.34,0,0,clemson_university,reject,89
306,158,148,93.0,2.34,0,0,clemson_university,reject,89
301,158,143,86.0,1.9,30,0,clemson_university,reject,89
314,162,152,104.0,2.35,38,2,clemson_university,reject,89
310,158,152,92.0,2.9,34,1,clemson_university,reject,89
314,162,152,110.0,2.0,15,0,clemson_university,reject,89
317,164,153,107.0,2.41,12,0,clemson_university,reject,89
311,162,149,100.0,1.4,41,0,clemson_university,reject,89
307,162,145,97.0,3.2,0,0,clemson_university,reject,89
321,166,155,101.0,2.81,5,0,clemson_university,reject,89
311,162,149,80.0,3.63,0,3,clemson_university,reject,89
305,155,150,94.0,3.21,30,0,clemson_university,reject,89
309,167,142,91.0,2.96,60,0,clemson_university,reject,89
311,164,147,101,3.4,20,0,clemson_university,reject,89
309,158,151,101,3.16,30,0,clemson_university,reject,89
315,164,151,103.0,2.0,30,3,clemson_university,reject,89
309,165,144,97.0,2.99,22,0,clemson_university,reject,89
318,168,150,106.0,1.88,18,3,clemson_university,reject,89
334,170,164,115.0,2.8,60,0,clemson_university,reject,89
308,156,152,99.0,3.12,0,1,clemson_university,reject,89
308,164,144,101,2.85,11,0,george_mason_university,accept,59
308,164,144,101,2.85,11,0,george_mason_university,accept,59
301,156,145,75.0,3.43,0,0,george_mason_university,accept,59
308,158,150,101,3.3,0,0,george_mason_university,accept,59
318,160,158,107.0,3.56,0,0,george_mason_university,accept,59
309,168,141,98.0,3.16,9,0,george_mason_university,accept,59
308,161,147,102.0,2.72,0,0,george_mason_university,accept,59
318,161,157,114,3.26,33,0,george_mason_university,accept,59
310,160,150,102.0,3.14,5,0,george_mason_university,accept,59
315,164,151,114,2.55,23,0,george_mason_university,accept,59
307,162,145,89.0,2.61,18,0,george_mason_university,accept,59
305,161,144,97.0,2.63,13,0,george_mason_university,accept,59
305,160,145,101,2.75,1,0,george_mason_university,accept,59
310,157,153,114,3.54,0,0,george_mason_university,accept,59
306,156,150,108.0,3.38,1,0,george_mason_university,accept,59
313,164,149,98.0,3.05,0,0,george_mason_university,accept,59
305,162,143,101,3.0,3,0,george_mason_university,accept,59
306,161,145,93.0,3.36,0,0,george_mason_university,accept,59
306,159,147,101.0,2.35,3,0,george_mason_university,accept,59
308,164,144,101,2.85,11,0,george_mason_university,accept,59
308,164,144,101,2.85,11,0,george_mason_university,accept,59
301,156,145,75.0,3.43,0,0,george_mason_university,accept,59
308,158,150,101,3.3,0,0,george_mason_university,accept,59
318,160,158,107.0,3.56,0,0,george_mason_university,accept,59
309,168,141,98.0,3.16,9,0,george_mason_university,accept,59
308,161,147,102.0,2.72,0,0,george_mason_university,accept,59
318,161,157,114,3.26,33,0,george_mason_university,accept,59
310,160,150,102.0,3.14,5,0,george_mason_university,accept,59
315,164,151,114,2.55,23,0,george_mason_university,accept,59
307,162,145,89.0,2.61,18,0,george_mason_university,accept,59
305,161,144,97.0,2.63,13,0,george_mason_university,accept,59
305,160,145,101,2.75,1,0,george_mason_university,accept,59
310,157,153,114,3.54,0,0,george_mason_university,accept,59
306,156,150,108.0,3.38,1,0,george_mason_university,accept,59
313,164,149,98.0,3.05,0,0,george_mason_university,accept,59
305,162,143,101,3.0,3,0,george_mason_university,accept,59
306,161,145,93.0,3.36,0,0,george_mason_university,accept,59
306,159,147,101.0,2.35,3,0,george_mason_university,accept,59
302,159,143,65.0,3.58,0,0,george_mason_university,accept,59
302,159,143,65.0,3.58,0,0,george_mason_university,accept,59
306,158,148,101,3.11,14,3,george_mason_university,accept,59
301,156,145,75.0,3.72,18,0,george_mason_university,accept,59
308,160,148,101,2.64,8,3,george_mason_university,accept,59
302,159,143,92.0,2.2,45,0,george_mason_university,accept,59
309,157,152,92.0,2.78,38,0,george_mason_university,accept,59
306,157,149,91.0,2.12,44,0,george_mason_university,accept,59
311,163,148,98.0,3.02,46,0,george_mason_university,accept,59
305,162,143,107.0,2.75,5,0,george_mason_university,accept,59
304,155,149,100.0,2.15,14,2,george_mason_university,accept,59
313,164,149,90.0,3.28,15,1,george_mason_university,accept,59
304,159,145,96.0,2.55,0,0,george_mason_university,accept,59
287,146,141,90.0,2.77,0,0,george_mason_university,accept,59
306,156,150,114,2.1,31,0,george_mason_university,accept,59
293,155,138,101,2.88,7,0,george_mason_university,accept,59
313,161,152,107.0,3.27,6,2,george_mason_university,accept,59
311,157,154,97.0,2.11,60,0,george_mason_university,accept,59
311,159,152,114,2.31,14,0,george_mason_university,accept,59
310,165,145,90.0,3.47,0,0,george_mason_university,accept,59
313,168,145,75.0,3.36,0,0,george_mason_university,accept,59
313,168,145,75.0,3.36,0,0,george_mason_university,accept,59
308,158,150,101.0,3.49,0,3,george_mason_university,accept,59
311,160,151,93.0,2.1,26,3,george_mason_university,accept,59
305,156,149,98.0,2.6,36,0,george_mason_university,accept,59
299,162,137,75.0,3.92,0,0,george_mason_university,accept,59
290,156,134,65.0,3.43,18,0,george_mason_university,accept,59
312,167,145,0,2.3,0,0,george_mason_university,accept,59
309,160,149,111.0,2.25,19,0,george_mason_university,accept,59
305,158,147,101,3.23,0,0,george_mason_university,accept,59
300,155,145,114,3.36,2,0,george_mason_university,accept,59
316,160,156,102.0,2.39,1,0,george_mason_university,accept,59
313,160,153,97.0,3.29,0,3,george_mason_university,accept,59
306,159,147,88.0,3.34,48,0,george_mason_university,accept,59
304,158,146,91.0,2.91,0,3,george_mason_university,accept,59
304,160,144,99.0,3.1,2,0,george_mason_university,accept,59
308,160,148,87.0,3.0,19,0,george_mason_university,accept,59
308,162,146,101,2.9,0,0,george_mason_university,accept,59
304,155,149,101,2.75,30,0,george_mason_university,accept,59
305,158,147,75.0,2.94,1,0,george_mason_university,accept,59
305,158,147,75.0,2.94,1,0,george_mason_university,accept,59
319,162,157,107.0,2.75,90,0,george_mason_university,accept,59
310,161,149,107.0,2.8,0,0,george_mason_university,accept,59
301,155,146,101,2.81,0,0,george_mason_university,accept,59
328,163,165,0,2.29,12,0,george_mason_university,accept,59
306,157,149,106.0,3.52,0,3,george_mason_university,accept,59
313,165,148,107.0,2.4,0,0,george_mason_university,accept,59
313,163,150,101,3.11,5,0,george_mason_university,accept,59
308,161,147,65.0,3.23,29,0,george_mason_university,accept,59
305,158,147,94.0,2.64,24,0,george_mason_university,accept,59
319,166,153,109.0,2.76,46,0,george_mason_university,accept,59
314,162,152,105.0,3.4,41,0,george_mason_university,accept,59
307,157,150,105.0,2.22,26,0,george_mason_university,accept,59
311,160,151,111.0,2.49,26,2,george_mason_university,accept,59
307,164,143,93.0,3.21,22,3,george_mason_university,accept,59
311,162,149,107.0,3.13,3,3,george_mason_university,accept,59
314,167,147,75.0,3.55,0,0,george_mason_university,accept,59
309,159,150,105.0,3.36,1,0,george_mason_university,accept,59
309,159,150,105.0,3.36,1,0,george_mason_university,accept,59
309,160,149,101,2.5,15,0,george_mason_university,accept,59
309,159,150,65.0,3.64,24,0,george_mason_university,accept,59
313,165,148,91.0,2.17,38,0,george_mason_university,accept,59
317,165,152,105.0,2.16,1,3,george_mason_university,accept,59
297,160,137,101,2.85,60,0,george_mason_university,accept,59
316,161,155,105.0,2.6,30,2,george_mason_university,accept,59
307,162,145,75.0,3.4,0,0,george_mason_university,accept,59
310,159,151,103.0,3.24,5,0,george_mason_university,accept,59
316,167,149,96.0,2.51,24,0,george_mason_university,accept,59
313,167,146,97.0,2.81,60,0,george_mason_university,accept,59
295,158,137,78,2.5,1,0,george_mason_university,accept,59
306,156,150,98.0,2.98,0,0,george_mason_university,accept,59
310,158,152,100.0,3.3,0,3,george_mason_university,accept,59
306,157,149,105.0,3.2,12,0,george_mason_university,accept,59
306,164,142,101,3.6,0,0,george_mason_university,accept,59
309,160,149,101.0,2.93,0,0,george_mason_university,accept,59
310,160,150,95.0,3.13,0,0,george_mason_university,accept,59
314,164,150,101,1.8,1,0,george_mason_university,accept,59
309,159,150,94.0,3.5,0,0,george_mason_university,accept,59
309,159,150,94.0,3.5,0,0,george_mason_university,accept,59
307,160,147,93.0,2.96,2,0,george_mason_university,accept,59
301,157,144,93.0,2.6,5,0,george_mason_university,accept,59
314,156,158,106.0,1.75,42,0,george_mason_university,accept,59
315,164,151,103.0,2.0,30,3,george_mason_university,accept,59
310,162,148,97.0,3.2,0,0,george_mason_university,accept,59
311,162,149,100.0,2.55,0,0,george_mason_university,accept,59
319,162,157,111.0,3.13,1,0,george_mason_university,accept,59
310,157,153,105.0,2.0,4,0,george_mason_university,accept,59
305,163,142,65.0,2.85,0,0,george_mason_university,accept,59
304,156,148,105.0,3.48,0,0,george_mason_university,accept,59
303,160,143,87.0,2.0,38,2,george_mason_university,accept,59
315,162,153,116.0,1.98,6,3,george_mason_university,accept,59
307,158,149,107.0,2.28,40,0,george_mason_university,accept,59
302,162,140,82.0,3.68,0,0,george_mason_university,accept,59
304,159,145,90.0,1.81,0,3,george_mason_university,accept,59
317,165,152,104.0,2.4,19,0,george_mason_university,accept,59
319,163,156,105.0,2.8,0,0,george_mason_university,accept,59
311,161,150,105.0,2.28,15,0,george_mason_university,accept,59
308,161,147,101,2.48,3,0,george_mason_university,accept,59
308,161,147,101,2.48,3,0,george_mason_university,accept,59
313,158,155,107.0,3.4,0,0,george_mason_university,accept,59
312,161,151,109.0,2.11,0,3,george_mason_university,accept,59
302,144,158,95.0,3.07,61,0,george_mason_university,accept,59
317,165,152,104.0,1.95,26,0,george_mason_university,accept,59
307,163,144,102.0,3.15,0,0,george_mason_university,accept,59
311,162,149,104.0,3.51,0,2,george_mason_university,accept,59
309,159,150,93.0,3.52,1,0,george_mason_university,accept,59
305,162,143,96.0,2.8,0,0,george_mason_university,accept,59
313,161,152,96.0,3.04,0,0,george_mason_university,accept,59
310,159,151,107.0,3.08,0,0,george_mason_university,accept,59
316,162,154,109.0,2.73,61,0,george_mason_university,accept,59
313,162,151,100.0,3.0,0,0,george_mason_university,accept,59
308,162,146,91.0,2.55,10,0,george_mason_university,accept,59
307,162,145,97.0,3.2,0,0,george_mason_university,accept,59
310,165,145,99.0,3.2,0,0,george_mason_university,accept,59
311,161,150,103.0,3.1,6,2,george_mason_university,accept,59
303,156,147,92.0,3.25,8,0,george_mason_university,accept,59
315,167,148,101.0,2.09,30,0,george_mason_university,accept,59
314,166,148,93.0,3.32,0,0,george_mason_university,accept,59
305,163,142,75.0,3.25,0,3,george_mason_university,accept,59
305,163,142,75.0,3.25,0,3,george_mason_university,accept,59
305,158,147,91.0,1.92,26,3,george_mason_university,accept,59
308,162,146,91.0,2.45,3,0,george_mason_university,accept,59
315,161,154,108.0,3.28,1,0,george_mason_university,accept,59
309,162,147,101.0,2.95,0,0,george_mason_university,accept,59
306,160,146,98.0,2.35,1,1,george_mason_university,accept,59
306,158,148,99.0,2.35,15,1,george_mason_university,accept,59
308,160,148,105.0,3.1,16,0,george_mason_university,accept,59
316,167,149,106.0,2.3,17,0,george_mason_university,accept,59
309,161,148,109.0,3.25,4,0,george_mason_university,accept,59
318,160,158,110.0,3.26,0,0,george_mason_university,accept,59
312,160,152,75.0,3.07,18,0,george_mason_university,reject,59
312,160,152,75.0,3.07,18,0,george_mason_university,reject,59
285,145,140,82.0,2.85,67,3,george_mason_university,reject,59
297,156,141,80.0,2.48,13,0,george_mason_university,reject,59
316,161,155,109.0,2.68,32,2,george_mason_university,reject,59
295,147,148,92.0,3.44,24,0,george_mason_university,reject,59
297,160,137,101,2.2,3,0,george_mason_university,reject,59
304,154,150,92.0,3.2,1,0,george_mason_university,reject,59
305,157,148,101,2.86,30,0,george_mason_university,reject,59
289,153,136,101,3.6,1,0,george_mason_university,reject,59
305,161,144,65.0,2.6,37,0,george_mason_university,reject,59
315,165,150,97.0,2.32,5,0,george_mason_university,reject,59
310,165,145,94.0,2.9,36,0,george_mason_university,reject,59
303,154,149,91.0,1.25,33,0,george_mason_university,reject,59
307,161,146,101,2.85,0,0,george_mason_university,reject,59
315,162,153,105.0,2.53,40,0,george_mason_university,reject,59
305,159,146,82.0,2.15,60,0,george_mason_university,reject,59
299,156,143,65.0,2.8,16,0,george_mason_university,reject,59
305,160,145,75.0,2.3,0,0,george_mason_university,reject,59
307,162,145,101,2.88,0,0,george_mason_university,reject,59
312,160,152,75.0,3.07,18,0,george_mason_university,reject,59
312,160,152,75.0,3.07,18,0,george_mason_university,reject,59
285,145,140,82.0,2.85,67,3,george_mason_university,reject,59
297,156,141,80.0,2.48,13,0,george_mason_university,reject,59
316,161,155,109.0,2.68,32,2,george_mason_university,reject,59
295,147,148,92.0,3.44,24,0,george_mason_university,reject,59
297,160,137,101,2.2,3,0,george_mason_university,reject,59
304,154,150,92.0,3.2,1,0,george_mason_university,reject,59
305,157,148,101,2.86,30,0,george_mason_university,reject,59
289,153,136,101,3.6,1,0,george_mason_university,reject,59
305,161,144,65.0,2.6,37,0,george_mason_university,reject,59
315,165,150,97.0,2.32,5,0,george_mason_university,reject,59
310,165,145,94.0,2.9,36,0,george_mason_university,reject,59
303,154,149,91.0,1.25,33,0,george_mason_university,reject,59
307,161,146,101,2.85,0,0,george_mason_university,reject,59
315,162,153,105.0,2.53,40,0,george_mason_university,reject,59
305,159,146,82.0,2.15,60,0,george_mason_university,reject,59
299,156,143,65.0,2.8,16,0,george_mason_university,reject,59
305,160,145,75.0,2.3,0,0,george_mason_university,reject,59
307,162,145,101,2.88,0,0,george_mason_university,reject,59
311,167,144,95.0,2.72,12,0,george_mason_university,reject,59
314,165,149,65.0,2.3,25,0,george_mason_university,reject,59
305,160,145,114,3.2,2,0,george_mason_university,reject,59
304,159,145,101,3.52,0,0,george_mason_university,reject,59
309,165,144,114,2.95,1,0,george_mason_university,reject,59
302,164,138,0,2.76,20,0,george_mason_university,reject,59
312,147,165,106.0,2.75,15,3,george_mason_university,reject,59
304,167,137,65.0,3.02,0,0,george_mason_university,reject,59
311,161,150,95.0,2.1,20,0,george_mason_university,reject,59
301,156,145,101,2.54,2,0,george_mason_university,reject,59
299,155,144,0,3.69,18,0,george_mason_university,reject,59
304,158,146,94.0,2.53,0,0,george_mason_university,reject,59
300,156,144,75.0,2.5,11,0,george_mason_university,reject,59
310,169,141,0,3.64,3,0,george_mason_university,reject,59
318,165,153,116.0,2.23,25,0,george_mason_university,reject,59
303,161,142,86.0,3.12,3,0,george_mason_university,reject,59
308,159,149,93.0,1.96,33,3,george_mason_university,reject,59
302,160,142,97.0,3.18,32,0,george_mason_university,reject,59
310,163,147,99.0,2.72,13,0,george_mason_university,reject,59
309,164,145,101,3.46,5,3,george_mason_university,reject,59
299,155,144,65.0,2.0,1,0,george_mason_university,reject,59
318,169,149,75.0,2.53,14,3,george_mason_university,reject,59
300,156,144,95.0,2.9,16,3,george_mason_university,reject,59
316,164,152,91.0,2.6,0,0,george_mason_university,reject,59
303,165,138,65.0,2.76,0,0,george_mason_university,reject,59
305,157,148,75.0,2.88,0,2,george_mason_university,reject,59
305,160,145,88.0,2.35,60,1,george_mason_university,reject,59
321,163,158,110.0,3.1,0,0,george_mason_university,reject,59
308,158,150,75.0,2.35,0,0,george_mason_university,reject,59
303,146,157,91.0,2.71,2,0,george_mason_university,reject,59
301,149,152,103.0,2.6,36,0,george_mason_university,reject,59
307,158,149,101,2.35,0,0,george_mason_university,reject,59
323,161,162,112.0,2.36,0,0,george_mason_university,reject,59
300,160,140,65.0,2.1,17,0,george_mason_university,reject,59
320,163,157,107.0,2.92,26,0,george_mason_university,reject,59
315,161,154,107.0,2.02,60,0,george_mason_university,reject,59
302,157,145,65.0,3.27,24,0,george_mason_university,reject,59
300,157,143,65.0,2.84,0,0,george_mason_university,reject,59
300,155,145,65.0,2.45,0,0,george_mason_university,reject,59
300,155,145,65.0,2.45,0,0,george_mason_university,reject,59
299,156,143,101,3.08,18,0,george_mason_university,reject,59
304,157,147,101.0,2.12,15,3,george_mason_university,reject,59
307,156,151,110.0,3.32,30,0,george_mason_university,reject,59
307,156,151,110.0,3.32,30,0,george_mason_university,reject,59
302,153,149,99.0,2.13,36,0,george_mason_university,reject,59
307,155,152,104.0,1.95,5,3,george_mason_university,reject,59
300,156,144,102.0,2.15,20,0,george_mason_university,reject,59
301,158,143,101,2.8,0,0,george_mason_university,reject,59
317,160,157,109.0,2.63,0,0,george_mason_university,reject,59
321,161,160,114.0,2.72,0,0,george_mason_university,reject,59
307,158,149,94.0,2.92,0,0,george_mason_university,reject,59
309,157,152,108.0,2.97,0,3,george_mason_university,reject,59
304,156,148,95.0,3.12,18,0,george_mason_university,reject,59
313,167,146,103.0,1.88,12,0,george_mason_university,reject,59
306,158,148,97.0,2.15,25,0,george_mason_university,reject,59
312,162,150,99.0,2.72,6,0,george_mason_university,reject,59
316,163,153,111.0,3.64,14,0,georgia_institiute_of_technology,accept,9
316,163,153,111.0,3.64,14,0,georgia_institiute_of_technology,accept,9
315,167,148,110.0,3.74,20,0,georgia_institiute_of_technology,accept,9
331,167,164,112.0,3.44,5,0,georgia_institiute_of_technology,accept,9
325,170,155,107.0,3.7,26,0,georgia_institiute_of_technology,accept,9
330,169,161,105.0,3.75,3,3,georgia_institiute_of_technology,accept,9
327,169,158,112.0,3.84,15,2,georgia_institiute_of_technology,accept,9
325,170,155,104.0,3.57,16,3,georgia_institiute_of_technology,accept,9
337,170,167,118.0,3.65,27,0,georgia_institiute_of_technology,accept,9
327,170,157,110.0,3.64,0,0,georgia_institiute_of_technology,accept,9
325,170,155,106.0,3.71,2,0,georgia_institiute_of_technology,accept,9
325,165,160,107.0,3.64,0,0,georgia_institiute_of_technology,accept,9
319,170,149,105.0,3.36,22,3,georgia_institiute_of_technology,accept,9
322,169,153,112.0,3.88,20,3,georgia_institiute_of_technology,accept,9
340,170,170,116.0,3.46,2,2,georgia_institiute_of_technology,accept,9
319,162,157,111.0,3.31,35,3,georgia_institiute_of_technology,accept,9
328,168,160,110.0,3.6,14,1,georgia_institiute_of_technology,accept,9
316,163,153,111.0,3.64,14,0,georgia_institiute_of_technology,accept,9
316,163,153,111.0,3.64,14,0,georgia_institiute_of_technology,accept,9
331,167,164,112.0,3.44,5,0,georgia_institiute_of_technology,accept,9
325,170,155,107.0,3.7,26,0,georgia_institiute_of_technology,accept,9
330,169,161,105.0,3.75,3,3,georgia_institiute_of_technology,accept,9
323,168,155,108.0,2.64,6,3,georgia_institiute_of_technology,accept,9
325,170,155,104.0,3.57,16,3,georgia_institiute_of_technology,accept,9
337,170,167,118.0,3.65,27,0,georgia_institiute_of_technology,accept,9
327,170,157,110.0,3.64,0,0,georgia_institiute_of_technology,accept,9
317,159,158,113.0,3.66,30,1,georgia_institiute_of_technology,accept,9
325,165,160,107.0,3.64,0,0,georgia_institiute_of_technology,accept,9
319,170,149,105.0,3.36,22,3,georgia_institiute_of_technology,accept,9
322,169,153,112.0,3.88,20,3,georgia_institiute_of_technology,accept,9
337,169,168,107.0,3.25,18,0,georgia_institiute_of_technology,accept,9
319,162,157,111.0,3.31,35,3,georgia_institiute_of_technology,accept,9
328,168,160,110.0,3.6,14,1,georgia_institiute_of_technology,accept,9
334,167,167,119.0,3.5,50,0,georgia_institiute_of_technology,accept,9
329,170,159,116.0,3.42,6,3,georgia_institiute_of_technology,accept,9
322,163,159,110.0,3.48,9,0,georgia_institiute_of_technology,accept,9
314,165,149,99.0,2.65,28,0,georgia_institiute_of_technology,accept,9
311,155,156,108.0,3.0,60,3,georgia_institiute_of_technology,accept,9
318,168,150,110.0,3.4,0,3,georgia_institiute_of_technology,accept,9
321,169,152,104.0,3.7,30,0,georgia_institiute_of_technology,accept,9
338,170,168,116.0,3.66,24,0,georgia_institiute_of_technology,accept,9
325,168,157,110.0,3.0,32,0,georgia_institiute_of_technology,accept,9
330,170,160,116.0,3.28,0,0,georgia_institiute_of_technology,accept,9
319,167,152,105.0,3.48,32,0,georgia_institiute_of_technology,accept,9
325,164,161,0,3.56,39,0,georgia_institiute_of_technology,accept,9
322,163,159,113.0,3.52,4,0,georgia_institiute_of_technology,accept,9
331,170,161,112.0,3.8,16,0,georgia_institiute_of_technology,accept,9
320,167,153,0,3.72,30,0,georgia_institiute_of_technology,accept,9
324,166,158,114.0,3.76,13,3,georgia_institiute_of_technology,accept,9
326,167,159,112.0,3.67,5,0,georgia_institiute_of_technology,accept,9
325,167,158,110.0,3.85,5,3,georgia_institiute_of_technology,accept,9
338,170,168,0,3.46,15,3,georgia_institiute_of_technology,accept,9
321,170,151,105.0,3.45,30,0,georgia_institiute_of_technology,accept,9
321,164,157,114.0,3.56,38,0,georgia_institiute_of_technology,accept,9
322,167,155,112.0,3.49,8,3,georgia_institiute_of_technology,accept,9
322,165,157,118.0,1.5,0,0,georgia_institiute_of_technology,accept,9
321,155,166,117.0,2.35,0,0,georgia_institiute_of_technology,accept,9
328,168,160,111.0,3.36,18,0,georgia_institiute_of_technology,accept,9
325,169,156,103.0,3.92,0,3,georgia_institiute_of_technology,accept,9
325,169,156,103.0,3.92,0,3,georgia_institiute_of_technology,accept,9
326,168,158,107.0,3.21,25,3,georgia_institiute_of_technology,accept,9
316,164,152,107.0,3.79,29,0,georgia_institiute_of_technology,accept,9
329,167,162,118.0,3.37,45,0,georgia_institiute_of_technology,accept,9
331,170,161,115.0,3.72,4,2,georgia_institiute_of_technology,accept,9
324,168,156,111.0,3.32,15,3,georgia_institiute_of_technology,accept,9
318,170,148,113.0,3.2,12,0,georgia_institiute_of_technology,accept,9
332,169,163,112.0,3.44,15,3,georgia_institiute_of_technology,accept,9
331,170,161,115.0,3.24,20,3,georgia_institiute_of_technology,accept,9
331,170,161,113.0,3.64,40,3,georgia_institiute_of_technology,accept,9
320,165,155,106.0,3.2,0,0,georgia_institiute_of_technology,accept,9
321,168,153,110.0,3.83,39,3,georgia_institiute_of_technology,accept,9
328,170,158,107.0,3.3,2,3,georgia_institiute_of_technology,accept,9
328,165,163,104.0,3.52,48,0,georgia_institiute_of_technology,accept,9
321,166,155,113.0,3.48,12,3,georgia_institiute_of_technology,accept,9
333,168,165,114.0,3.33,10,3,georgia_institiute_of_technology,accept,9
333,168,165,114.0,3.33,10,3,georgia_institiute_of_technology,accept,9
321,168,153,115.0,3.93,8,0,georgia_institiute_of_technology,accept,9
322,170,152,109.0,3.76,20,3,georgia_institiute_of_technology,accept,9
327,170,157,107.0,3.8,20,3,georgia_institiute_of_technology,accept,9
318,163,155,95.0,3.2,10,3,georgia_institiute_of_technology,accept,9
328,170,158,110.0,3.17,10,0,georgia_institiute_of_technology,accept,9
318,163,155,109.0,3.68,30,3,georgia_institiute_of_technology,accept,9
322,170,152,112.0,3.78,30,0,georgia_institiute_of_technology,accept,9
325,168,157,110.0,3.64,10,0,georgia_institiute_of_technology,accept,9
325,166,159,113.0,3.6,20,3,georgia_institiute_of_technology,accept,9
329,164,165,117.0,2.56,0,0,georgia_institiute_of_technology,accept,9
321,161,160,103.0,2.5,30,1,georgia_institiute_of_technology,accept,9
324,168,156,107.0,2.84,13,1,georgia_institiute_of_technology,reject,9
329,166,163,114.0,3.25,3,0,georgia_institiute_of_technology,reject,9
322,165,157,118.0,3.56,1,0,georgia_institiute_of_technology,reject,9
320,165,155,107.0,2.93,29,0,georgia_institiute_of_technology,reject,9
328,167,161,117.0,3.28,16,0,georgia_institiute_of_technology,reject,9
322,164,158,118.0,3.41,12,0,georgia_institiute_of_technology,reject,9
323,170,153,111.0,3.44,34,0,georgia_institiute_of_technology,reject,9
326,170,156,109.0,3.27,0,0,georgia_institiute_of_technology,reject,9
327,167,160,114.0,3.35,48,2,georgia_institiute_of_technology,reject,9
322,169,153,114.0,2.85,8,3,georgia_institiute_of_technology,reject,9
335,170,165,109.0,3.63,6,0,georgia_institiute_of_technology,reject,9
317,167,150,110.0,3.76,13,0,georgia_institiute_of_technology,reject,9
321,164,157,104.0,3.52,10,3,georgia_institiute_of_technology,reject,9
332,170,162,117.0,3.78,0,0,georgia_institiute_of_technology,reject,9
329,170,159,111.0,3.88,20,3,georgia_institiute_of_technology,reject,9
318,163,155,107.0,2.95,46,0,georgia_institiute_of_technology,reject,9
329,166,163,114.0,3.25,3,0,georgia_institiute_of_technology,reject,9
322,165,157,118.0,3.56,1,0,georgia_institiute_of_technology,reject,9
320,165,155,107.0,2.93,29,0,georgia_institiute_of_technology,reject,9
327,168,159,109.0,3.46,14,0,georgia_institiute_of_technology,reject,9
322,164,158,118.0,3.41,12,0,georgia_institiute_of_technology,reject,9
323,170,153,111.0,3.44,34,0,georgia_institiute_of_technology,reject,9
326,170,156,109.0,3.27,0,0,georgia_institiute_of_technology,reject,9
318,165,153,108.0,3.84,9,3,georgia_institiute_of_technology,reject,9
322,169,153,114.0,2.85,8,3,georgia_institiute_of_technology,reject,9
335,170,165,109.0,3.63,6,0,georgia_institiute_of_technology,reject,9
317,167,150,110.0,3.76,13,0,georgia_institiute_of_technology,reject,9
317,165,152,110.0,3.87,16,3,georgia_institiute_of_technology,reject,9
332,170,162,117.0,3.78,0,0,georgia_institiute_of_technology,reject,9
329,170,159,111.0,3.88,20,3,georgia_institiute_of_technology,reject,9
313,163,150,101.0,3.6,60,2,georgia_institiute_of_technology,reject,9
327,167,160,117.0,3.67,6,0,georgia_institiute_of_technology,reject,9
325,167,158,114.0,3.48,1,0,georgia_institiute_of_technology,reject,9
313,165,148,103.0,2.94,60,0,georgia_institiute_of_technology,reject,9
329,170,159,111.0,3.65,48,0,georgia_institiute_of_technology,reject,9
320,165,155,107.0,3.6,24,0,georgia_institiute_of_technology,reject,9
316,164,152,106.0,2.9,9,3,georgia_institiute_of_technology,reject,9
314,162,152,105.0,3.47,14,0,georgia_institiute_of_technology,reject,9
319,164,155,113.0,1.9,94,0,georgia_institiute_of_technology,reject,9
318,164,154,106.0,2.82,6,0,georgia_institiute_of_technology,reject,9
308,157,151,104.0,2.35,15,0,illinois_institute_of_technology,accept,97
308,157,151,104.0,2.35,15,0,illinois_institute_of_technology,accept,97
293,152,141,75.0,2.95,5,0,illinois_institute_of_technology,accept,97
322,167,155,103.0,3.08,20,3,illinois_institute_of_technology,accept,97
317,162,155,101.0,3.46,48,0,illinois_institute_of_technology,accept,97
312,164,148,114,3.29,3,2,illinois_institute_of_technology,accept,97
317,164,153,109.0,2.75,41,0,illinois_institute_of_technology,accept,97
300,160,140,65.0,3.19,4,3,illinois_institute_of_technology,accept,97
310,162,148,97.0,2.92,0,0,illinois_institute_of_technology,accept,97
302,162,140,86.0,2.88,43,0,illinois_institute_of_technology,accept,97
296,155,141,88.0,2.79,1,0,illinois_institute_of_technology,accept,97
305,160,145,101,3.0,2,0,illinois_institute_of_technology,accept,97
305,162,143,65.0,2.94,13,0,illinois_institute_of_technology,accept,97
315,162,153,105.0,2.53,40,0,illinois_institute_of_technology,accept,97
300,159,141,65.0,3.29,17,0,illinois_institute_of_technology,accept,97
310,162,148,94.0,2.89,3,0,illinois_institute_of_technology,accept,97
306,160,146,101,3.39,10,3,illinois_institute_of_technology,accept,97
305,161,144,94.0,3.26,10,0,illinois_institute_of_technology,accept,97
306,145,161,75.0,3.1,11,0,illinois_institute_of_technology,accept,97
305,156,149,114,3.0,28,3,illinois_institute_of_technology,accept,97
324,169,155,108.0,3.29,30,2,illinois_institute_of_technology,accept,97
324,169,155,108.0,3.29,30,2,illinois_institute_of_technology,accept,97
304,162,142,89.0,2.33,25,0,illinois_institute_of_technology,accept,97
301,158,143,91.0,3.02,23,0,illinois_institute_of_technology,accept,97
305,156,149,95.0,3.16,29,2,illinois_institute_of_technology,accept,97
307,157,150,102.0,3.18,0,3,illinois_institute_of_technology,accept,97
312,164,148,95.0,2.58,13,0,illinois_institute_of_technology,accept,97
309,162,147,93.0,3.19,17,0,illinois_institute_of_technology,accept,97
313,165,148,101,2.96,16,0,illinois_institute_of_technology,accept,97
306,157,149,94.0,3.58,28,0,illinois_institute_of_technology,accept,97
302,162,140,95.0,2.65,8,0,illinois_institute_of_technology,accept,97
302,150,152,103.0,2.46,31,0,illinois_institute_of_technology,accept,97
300,159,141,65.0,3.29,18,0,illinois_institute_of_technology,accept,97
308,160,148,65.0,3.33,14,0,illinois_institute_of_technology,accept,97
303,156,147,93.0,2.5,4,0,illinois_institute_of_technology,accept,97
311,164,147,75.0,3.86,0,0,illinois_institute_of_technology,accept,97
317,163,154,111.0,2.97,20,3,illinois_institute_of_technology,accept,97
306,160,146,93.0,2.55,25,0,illinois_institute_of_technology,accept,97
310,163,147,98.0,2.25,46,3,illinois_institute_of_technology,accept,97
322,170,152,107.0,3.08,8,0,illinois_institute_of_technology,accept,97
315,161,154,104.0,2.18,4,1,illinois_institute_of_technology,accept,97
302,156,146,94.0,3.52,23,0,illinois_institute_of_technology,accept,97
302,156,146,94.0,3.52,23,0,illinois_institute_of_technology,accept,97
298,154,144,82.0,3.21,18,0,illinois_institute_of_technology,accept,97
299,155,144,75.0,2.9,1,3,illinois_institute_of_technology,accept,97
313,163,150,75.0,2.45,0,0,illinois_institute_of_technology,accept,97
308,162,146,97.0,3.07,68,0,illinois_institute_of_technology,accept,97
309,163,146,93.0,2.87,3,3,illinois_institute_of_technology,accept,97
319,168,151,103.0,2.73,30,0,illinois_institute_of_technology,accept,97
304,158,146,95.0,3.68,0,0,illinois_institute_of_technology,accept,97
293,142,151,92.0,2.5,60,0,illinois_institute_of_technology,accept,97
318,165,153,108.0,2.3,24,0,illinois_institute_of_technology,accept,97
326,165,161,113.0,2.98,1,0,illinois_institute_of_technology,accept,97
305,156,149,98.0,3.9,6,0,illinois_institute_of_technology,accept,97
308,160,148,102.0,2.81,0,0,illinois_institute_of_technology,accept,97
305,153,152,107.0,2.75,24,0,illinois_institute_of_technology,accept,97
302,159,143,99.0,2.81,17,0,illinois_institute_of_technology,accept,97
300,153,147,65.0,3.1,3,0,illinois_institute_of_technology,accept,97
306,156,150,106.0,3.5,1,2,illinois_institute_of_technology,accept,97
313,161,152,90.0,2.4,26,0,illinois_institute_of_technology,accept,97
313,161,152,90.0,2.4,26,0,illinois_institute_of_technology,accept,97
312,161,151,98.0,2.47,33,3,illinois_institute_of_technology,accept,97
310,160,150,93.0,2.26,26,0,illinois_institute_of_technology,accept,97
305,158,147,98.0,2.4,25,0,illinois_institute_of_technology,accept,97
300,160,140,75.0,3.48,17,0,illinois_institute_of_technology,accept,97
324,167,157,101.0,3.4,1,0,illinois_institute_of_technology,accept,97
309,160,149,101,3.5,24,3,illinois_institute_of_technology,accept,97
305,159,146,65.0,2.6,47,3,illinois_institute_of_technology,accept,97
310,164,146,75.0,3.63,3,0,illinois_institute_of_technology,accept,97
299,149,150,94.0,2.46,5,3,illinois_institute_of_technology,accept,97
306,158,148,110.0,3.49,28,0,illinois_institute_of_technology,accept,97
309,159,150,104.0,3.4,0,0,illinois_institute_of_technology,accept,97
312,160,152,114,2.25,12,3,illinois_institute_of_technology,accept,97
317,163,154,109.0,2.6,0,0,illinois_institute_of_technology,accept,97
315,165,150,94.0,2.81,30,3,illinois_institute_of_technology,accept,97
296,150,146,95.0,2.24,60,3,illinois_institute_of_technology,accept,97
316,167,149,101.0,3.08,32,0,illinois_institute_of_technology,accept,97
294,151,143,91.0,3.39,35,2,illinois_institute_of_technology,accept,97
300,155,145,105.0,3.23,0,3,illinois_institute_of_technology,accept,97
292,155,137,65.0,2.72,7,0,illinois_institute_of_technology,accept,97
316,161,155,109.0,2.68,32,2,illinois_institute_of_technology,accept,97
316,161,155,109.0,2.68,32,2,illinois_institute_of_technology,accept,97
323,166,157,109.0,3.62,32,0,illinois_institute_of_technology,accept,97
306,156,150,87.0,2.34,16,3,illinois_institute_of_technology,accept,97
300,155,145,65.0,2.4,6,3,illinois_institute_of_technology,accept,97
320,160,160,116.0,3.28,16,3,illinois_institute_of_technology,accept,97
307,155,152,97.0,2.6,1,0,illinois_institute_of_technology,accept,97
320,169,151,106.0,3.29,0,0,illinois_institute_of_technology,accept,97
316,161,155,111.0,2.55,32,0,illinois_institute_of_technology,accept,97
308,164,144,90.0,3.37,0,0,illinois_institute_of_technology,accept,97
308,164,144,101,2.37,19,0,illinois_institute_of_technology,accept,97
296,158,138,84.0,3.62,4,3,illinois_institute_of_technology,accept,97
305,141,164,88.0,2.97,0,0,illinois_institute_of_technology,accept,97
315,164,151,108.0,3.62,1,0,illinois_institute_of_technology,accept,97
302,160,142,75.0,3.64,6,3,illinois_institute_of_technology,accept,97
304,160,144,101,3.52,9,3,illinois_institute_of_technology,accept,97
305,160,145,92.0,3.12,24,1,illinois_institute_of_technology,accept,97
307,160,147,95.0,3.06,15,0,illinois_institute_of_technology,accept,97
304,164,140,75.0,3.1,26,0,illinois_institute_of_technology,accept,97
301,157,144,87.0,2.25,23,3,illinois_institute_of_technology,accept,97
318,164,154,108.0,3.36,0,0,illinois_institute_of_technology,accept,97
320,160,160,82.0,3.45,10,0,illinois_institute_of_technology,accept,97
305,158,147,95.0,3.72,10,0,illinois_institute_of_technology,accept,97
305,153,152,75.0,2.12,0,0,illinois_institute_of_technology,accept,97
300,155,145,95.0,3.14,18,1,illinois_institute_of_technology,accept,97
306,159,147,97.0,3.32,24,3,illinois_institute_of_technology,accept,97
305,158,147,101,3.38,4,0,illinois_institute_of_technology,accept,97
308,163,145,95.0,3.09,30,0,illinois_institute_of_technology,accept,97
292,160,132,78,3.4,2,0,illinois_institute_of_technology,accept,97
303,159,144,92.0,3.15,26,0,illinois_institute_of_technology,accept,97
305,159,146,101,3.45,37,0,illinois_institute_of_technology,accept,97
304,159,145,93.0,2.4,17,0,illinois_institute_of_technology,accept,97
304,155,149,95.0,2.76,35,0,illinois_institute_of_technology,accept,97
300,156,144,88.0,3.16,14,0,illinois_institute_of_technology,accept,97
312,159,153,107.0,3.34,0,0,illinois_institute_of_technology,accept,97
310,166,144,104.0,3.17,5,3,illinois_institute_of_technology,accept,97
311,165,146,88.0,2.8,0,0,illinois_institute_of_technology,accept,97
303,150,153,101,2.65,0,0,illinois_institute_of_technology,accept,97
295,153,142,101,2.35,31,0,illinois_institute_of_technology,accept,97
308,156,152,101,2.25,0,0,illinois_institute_of_technology,accept,97
309,163,146,90.0,3.05,5,3,illinois_institute_of_technology,accept,97
310,157,153,101,2.7,0,0,illinois_institute_of_technology,accept,97
305,155,150,102.0,2.8,10,0,illinois_institute_of_technology,accept,97
309,165,144,114,2.95,1,0,illinois_institute_of_technology,accept,97
306,162,144,0,3.12,3,0,illinois_institute_of_technology,accept,97
321,167,154,113.0,2.1,24,0,illinois_institute_of_technology,accept,97
302,154,148,84.0,2.4,0,0,illinois_institute_of_technology,accept,97
305,156,149,99.0,3.29,35,0,illinois_institute_of_technology,accept,97
305,156,149,92.0,3.25,0,0,illinois_institute_of_technology,accept,97
310,165,145,102.0,3.76,5,2,illinois_institute_of_technology,accept,97
322,165,157,110.0,2.4,30,0,illinois_institute_of_technology,accept,97
304,163,141,0,2.17,6,0,illinois_institute_of_technology,accept,97
304,163,141,0,2.17,6,0,illinois_institute_of_technology,accept,97
304,157,147,94.0,3.28,0,0,illinois_institute_of_technology,accept,97
298,153,145,0,3.24,20,0,illinois_institute_of_technology,accept,97
307,160,147,95.0,2.25,60,0,illinois_institute_of_technology,accept,97
296,155,141,88.0,2.67,42,0,illinois_institute_of_technology,accept,97
309,162,147,101,2.96,6,0,illinois_institute_of_technology,accept,97
303,154,149,105.0,2.56,0,3,illinois_institute_of_technology,accept,97
297,152,145,84.0,2.5,0,0,illinois_institute_of_technology,accept,97
308,161,147,107.0,3.49,57,2,illinois_institute_of_technology,accept,97
313,163,150,0,3.08,0,0,illinois_institute_of_technology,accept,97
302,164,138,0,2.76,20,0,illinois_institute_of_technology,accept,97
297,155,142,78,3.36,6,0,illinois_institute_of_technology,accept,97
306,165,141,0,2.4,33,3,illinois_institute_of_technology,accept,97
300,163,137,0,3.02,5,0,illinois_institute_of_technology,accept,97
315,166,149,98.0,3.36,1,3,illinois_institute_of_technology,accept,97
320,164,156,114.0,2.54,29,0,illinois_institute_of_technology,accept,97
320,164,156,114.0,2.54,29,0,illinois_institute_of_technology,accept,97
305,160,145,104.0,3.31,20,0,illinois_institute_of_technology,accept,97
296,160,136,101,3.64,0,0,illinois_institute_of_technology,accept,97
304,158,146,111.0,3.1,23,0,illinois_institute_of_technology,accept,97
303,158,145,92.0,2.28,36,0,illinois_institute_of_technology,accept,97
313,161,152,101.0,3.2,33,0,illinois_institute_of_technology,accept,97
299,157,142,101,3.6,60,0,illinois_institute_of_technology,accept,97
307,162,145,0,3.6,20,0,illinois_institute_of_technology,accept,97
291,152,139,101,2.45,7,0,illinois_institute_of_technology,accept,97
307,162,145,98.0,2.5,41,2,illinois_institute_of_technology,accept,97
309,164,145,87.0,2.23,28,0,illinois_institute_of_technology,accept,97
308,159,149,0,3.32,6,0,illinois_institute_of_technology,accept,97
314,166,148,105.0,2.77,16,0,illinois_institute_of_technology,accept,97
315,163,152,104.0,2.55,15,0,illinois_institute_of_technology,accept,97
309,159,150,104.0,2.6,26,0,illinois_institute_of_technology,accept,97
306,163,143,65.0,2.9,0,0,illinois_institute_of_technology,accept,97
301,159,142,101,3.16,27,0,illinois_institute_of_technology,accept,97
300,155,145,101,3.34,0,0,illinois_institute_of_technology,accept,97
319,168,151,115.0,3.67,24,2,illinois_institute_of_technology,accept,97
309,158,151,94.0,3.22,19,0,illinois_institute_of_technology,accept,97
309,158,151,94.0,3.22,19,0,illinois_institute_of_technology,accept,97
308,159,149,99.0,3.32,2,0,illinois_institute_of_technology,accept,97
308,156,152,103.0,2.25,0,0,illinois_institute_of_technology,accept,97
306,160,146,95.0,2.85,0,0,illinois_institute_of_technology,accept,97
307,158,149,92.0,3.84,19,0,illinois_institute_of_technology,accept,97
300,156,144,0,2.63,10,0,illinois_institute_of_technology,accept,97
312,160,152,0,2.55,0,0,illinois_institute_of_technology,accept,97
311,159,152,114,3.34,43,0,illinois_institute_of_technology,accept,97
318,167,151,103.0,2.84,10,3,illinois_institute_of_technology,accept,97
300,160,140,104.0,3.6,39,0,illinois_institute_of_technology,accept,97
306,165,141,81.0,2.75,16,0,illinois_institute_of_technology,accept,97
300,156,144,93.0,3.62,24,0,illinois_institute_of_technology,accept,97
300,155,145,93.0,3.12,13,0,illinois_institute_of_technology,accept,97
308,160,148,98.0,2.42,6,3,illinois_institute_of_technology,accept,97
307,167,140,101,3.37,0,0,illinois_institute_of_technology,accept,97
310,161,149,90.0,2.65,48,0,illinois_institute_of_technology,accept,97
306,153,153,101,3.2,0,0,illinois_institute_of_technology,accept,97
302,160,142,101,3.32,15,2,illinois_institute_of_technology,accept,97
322,169,153,115.0,2.64,2,0,illinois_institute_of_technology,accept,97
301,159,142,101,3.56,0,0,illinois_institute_of_technology,accept,97
301,159,142,101,3.56,0,0,illinois_institute_of_technology,accept,97
311,166,145,94.0,2.13,15,3,illinois_institute_of_technology,accept,97
305,158,147,96.0,3.08,0,0,illinois_institute_of_technology,accept,97
317,165,152,95.0,2.44,18,2,illinois_institute_of_technology,accept,97
301,154,147,91.0,3.26,39,0,illinois_institute_of_technology,accept,97
295,160,135,101,3.48,12,0,illinois_institute_of_technology,accept,97
305,158,147,0,2.26,30,0,illinois_institute_of_technology,accept,97
306,162,144,75.0,3.48,0,0,illinois_institute_of_technology,accept,97
299,155,144,96.0,2.15,26,0,illinois_institute_of_technology,accept,97
306,162,144,75.0,3.48,0,0,illinois_institute_of_technology,accept,97
299,155,144,96.0,2.15,26,0,illinois_institute_of_technology,accept,97
318,165,153,106.0,2.35,26,2,illinois_institute_of_technology,accept,97
311,158,153,114.0,3.61,5,0,illinois_institute_of_technology,accept,97
318,165,153,116.0,2.23,25,0,illinois_institute_of_technology,accept,97
306,158,148,96.0,2.4,9,3,illinois_institute_of_technology,accept,97
307,160,147,111.0,2.8,0,0,illinois_institute_of_technology,accept,97
304,162,142,97.0,2.9,0,0,illinois_institute_of_technology,accept,97
317,168,149,101.0,2.99,6,0,illinois_institute_of_technology,accept,97
302,152,150,0,3.56,2,0,illinois_institute_of_technology,accept,97
308,162,146,96.0,3.15,36,0,illinois_institute_of_technology,accept,97
307,164,143,101,3.24,0,0,illinois_institute_of_technology,accept,97
302,155,147,101,2.56,0,3,illinois_institute_of_technology,accept,97
305,161,144,99.0,2.27,2,0,illinois_institute_of_technology,accept,97
305,161,144,99.0,2.27,2,0,illinois_institute_of_technology,accept,97
308,163,145,87.0,2.67,48,1,illinois_institute_of_technology,accept,97
308,158,150,91.0,3.17,60,0,illinois_institute_of_technology,accept,97
305,154,151,101.0,1.95,28,3,illinois_institute_of_technology,accept,97
312,163,149,101,2.12,4,3,illinois_institute_of_technology,accept,97
317,161,156,105.0,3.19,0,0,illinois_institute_of_technology,accept,97
300,153,147,90.0,2.48,30,0,illinois_institute_of_technology,accept,97
309,160,149,96.0,3.36,7,0,illinois_institute_of_technology,accept,97
301,154,147,99.0,2.2,14,0,illinois_institute_of_technology,accept,97
323,165,158,109.0,2.88,2,0,illinois_institute_of_technology,accept,97
303,161,142,87.0,3.47,20,0,illinois_institute_of_technology,accept,97
318,160,158,106.0,3.59,0,0,illinois_institute_of_technology,accept,97
306,159,147,95.0,2.73,22,0,illinois_institute_of_technology,accept,97
304,155,149,87.0,3.27,0,0,illinois_institute_of_technology,accept,97
300,155,145,114,3.36,2,0,illinois_institute_of_technology,accept,97
301,156,145,0,3.28,16,0,illinois_institute_of_technology,accept,97
304,160,144,87.0,2.25,40,0,illinois_institute_of_technology,accept,97
305,165,140,101.0,3.2,18,0,illinois_institute_of_technology,accept,97
313,156,157,114,2.25,1,0,illinois_institute_of_technology,accept,97
314,162,152,89.0,3.12,0,0,illinois_institute_of_technology,accept,97
304,154,150,91.0,3.0,0,0,illinois_institute_of_technology,accept,97
304,154,150,91.0,3.0,0,0,illinois_institute_of_technology,accept,97
313,160,153,0,3.36,0,0,illinois_institute_of_technology,accept,97
300,158,142,92.0,2.4,30,3,illinois_institute_of_technology,accept,97
318,156,162,108.0,2.35,36,0,illinois_institute_of_technology,accept,97
309,162,147,93.0,2.25,1,0,illinois_institute_of_technology,accept,97
310,158,152,108.0,2.83,24,3,illinois_institute_of_technology,accept,97
312,162,150,102.0,3.2,18,0,illinois_institute_of_technology,accept,97
314,164,150,101,2.46,18,0,illinois_institute_of_technology,accept,97
315,163,152,101.0,3.68,0,0,illinois_institute_of_technology,accept,97
303,156,147,109.0,3.63,6,2,illinois_institute_of_technology,accept,97
307,163,144,101,2.86,28,1,illinois_institute_of_technology,accept,97
321,166,155,114,2.29,40,0,illinois_institute_of_technology,accept,97
304,163,141,88.0,2.95,57,0,illinois_institute_of_technology,accept,97
296,153,143,100.0,2.25,2,0,illinois_institute_of_technology,accept,97
304,158,146,90.0,3.67,0,0,illinois_institute_of_technology,accept,97
309,161,148,89.0,2.1,17,2,illinois_institute_of_technology,accept,97
301,160,141,74.0,3.14,4,0,illinois_institute_of_technology,accept,97
319,164,155,0,3.11,20,0,illinois_institute_of_technology,accept,97
309,157,152,108.0,3.1,26,0,illinois_institute_of_technology,accept,97
310,164,146,91.0,2.2,42,0,illinois_institute_of_technology,accept,97
300,157,143,88.0,2.35,12,2,illinois_institute_of_technology,accept,97
308,161,147,90.0,3.46,27,0,illinois_institute_of_technology,accept,97
304,160,144,99.0,3.6,0,0,illinois_institute_of_technology,accept,97
302,157,145,101,3.3,27,0,illinois_institute_of_technology,accept,97
300,154,146,89.0,3.28,3,1,illinois_institute_of_technology,accept,97
309,162,147,98.0,2.24,27,0,illinois_institute_of_technology,accept,97
307,164,143,0,3.33,0,2,illinois_institute_of_technology,accept,97
304,162,142,95.0,2.4,3,3,illinois_institute_of_technology,accept,97
311,162,149,102.0,2.45,0,3,illinois_institute_of_technology,accept,97
307,164,143,101.0,3.24,34,0,illinois_institute_of_technology,accept,97
313,160,153,97.0,2.33,18,0,illinois_institute_of_technology,accept,97
315,162,153,101.0,2.28,46,0,illinois_institute_of_technology,accept,97
297,152,145,87.0,2.44,2,1,illinois_institute_of_technology,accept,97
306,162,144,91.0,2.93,0,3,illinois_institute_of_technology,accept,97
324,169,155,0,2.0,18,0,illinois_institute_of_technology,accept,97
309,157,152,101.0,3.23,0,0,illinois_institute_of_technology,accept,97
298,155,143,101.0,3.08,0,0,illinois_institute_of_technology,reject,97
298,155,143,101.0,3.08,0,0,illinois_institute_of_technology,reject,97
311,163,148,101,2.55,2,0,illinois_institute_of_technology,reject,97
295,155,140,101,3.04,5,3,illinois_institute_of_technology,reject,97
290,151,139,86.0,2.05,46,0,illinois_institute_of_technology,reject,97
303,153,150,99.0,3.04,21,2,illinois_institute_of_technology,reject,97
310,159,151,93.0,2.78,14,0,illinois_institute_of_technology,reject,97
290,154,136,65.0,3.52,18,3,illinois_institute_of_technology,reject,97
303,156,147,87.0,3.08,27,0,illinois_institute_of_technology,reject,97
308,158,150,101,3.16,0,0,illinois_institute_of_technology,reject,97
302,156,146,108.0,2.47,39,0,illinois_institute_of_technology,reject,97
297,155,142,102.0,2.76,16,3,illinois_institute_of_technology,reject,97
314,160,154,107.0,2.99,24,0,illinois_institute_of_technology,reject,97
307,163,144,94.0,2.84,0,0,illinois_institute_of_technology,reject,97
308,157,151,95.0,2.55,1,0,illinois_institute_of_technology,reject,97
308,159,149,89.0,2.75,24,2,illinois_institute_of_technology,reject,97
305,145,160,101.0,1.95,50,2,illinois_institute_of_technology,reject,97
308,158,150,81.0,1.7,0,0,illinois_institute_of_technology,reject,97
304,155,149,75.0,2.7,0,0,illinois_institute_of_technology,reject,97
313,161,152,99.0,2.2,24,0,illinois_institute_of_technology,reject,97
298,155,143,101.0,3.08,0,0,illinois_institute_of_technology,reject,97
298,155,143,101.0,3.08,0,0,illinois_institute_of_technology,reject,97
311,163,148,101,2.55,2,0,illinois_institute_of_technology,reject,97
295,155,140,101,3.04,5,3,illinois_institute_of_technology,reject,97
290,151,139,86.0,2.05,46,0,illinois_institute_of_technology,reject,97
303,153,150,99.0,3.04,21,2,illinois_institute_of_technology,reject,97
310,159,151,93.0,2.78,14,0,illinois_institute_of_technology,reject,97
314,160,154,107.0,2.99,24,0,illinois_institute_of_technology,reject,97
307,163,144,94.0,2.84,0,0,illinois_institute_of_technology,reject,97
308,157,151,95.0,2.55,1,0,illinois_institute_of_technology,reject,97
308,159,149,89.0,2.75,24,2,illinois_institute_of_technology,reject,97
305,145,160,101.0,1.95,50,2,illinois_institute_of_technology,reject,97
308,158,150,81.0,1.7,0,0,illinois_institute_of_technology,reject,97
304,155,149,75.0,2.7,0,0,illinois_institute_of_technology,reject,97
313,161,152,99.0,2.2,24,0,illinois_institute_of_technology,reject,97
297,157,140,83.0,2.78,28,1,illinois_institute_of_technology,reject,97
297,157,140,83.0,2.78,28,1,illinois_institute_of_technology,reject,97
307,162,145,89.0,2.61,3,0,illinois_institute_of_technology,reject,97
302,157,145,65.0,2.42,15,0,illinois_institute_of_technology,reject,97
303,155,148,105.0,1.95,6,0,illinois_institute_of_technology,reject,97
308,160,148,85.0,2.07,7,3,illinois_institute_of_technology,reject,97
307,156,151,102.0,2.8,0,0,illinois_institute_of_technology,reject,97
300,158,142,65.0,2.56,0,0,illinois_institute_of_technology,reject,97
299,158,141,0,2.1,31,1,illinois_institute_of_technology,reject,97
293,137,156,65.0,2.89,0,3,illinois_institute_of_technology,reject,97
315,170,145,101,3.29,0,0,illinois_institute_of_technology,reject,97
303,160,143,89.0,2.87,24,1,illinois_institute_of_technology,reject,97
314,162,152,105.0,2.9,2,0,illinois_institute_of_technology,reject,97
308,158,150,0,2.92,23,0,illinois_institute_of_technology,reject,97
312,166,146,104.0,2.56,0,0,illinois_institute_of_technology,reject,97
298,155,143,65.0,2.25,12,0,illinois_institute_of_technology,reject,97
306,160,146,90.0,2.89,35,0,illinois_institute_of_technology,reject,97
303,155,148,82.0,2.17,0,0,illinois_institute_of_technology,reject,97
303,163,140,65.0,3.13,15,0,illinois_institute_of_technology,reject,97
291,153,138,65.0,3.42,50,0,illinois_institute_of_technology,reject,97
308,155,153,114,2.9,1,3,illinois_institute_of_technology,reject,97
308,155,153,114,2.9,1,3,illinois_institute_of_technology,reject,97
311,154,157,113.0,2.97,2,0,illinois_institute_of_technology,reject,97
300,159,141,87.0,2.96,0,0,illinois_institute_of_technology,reject,97
295,151,144,96.0,3.17,30,0,illinois_institute_of_technology,reject,97
298,157,141,91.0,1.76,28,3,illinois_institute_of_technology,reject,97
301,156,145,100.0,2.57,0,3,illinois_institute_of_technology,reject,97
292,152,140,98.0,2.8,24,3,illinois_institute_of_technology,reject,97
309,157,152,97.0,2.1,57,0,illinois_institute_of_technology,reject,97
299,149,150,110.0,2.46,9,0,illinois_institute_of_technology,reject,97
298,150,148,106.0,2.11,15,3,illinois_institute_of_technology,reject,97
318,163,155,112.0,2.45,0,3,illinois_institute_of_technology,reject,97
307,158,149,78,2.76,26,0,illinois_institute_of_technology,reject,97
298,153,145,96.0,3.28,0,3,illinois_institute_of_technology,reject,97
298,153,145,96.0,3.28,0,3,illinois_institute_of_technology,reject,97
296,150,146,85.0,2.42,0,0,illinois_institute_of_technology,reject,97
302,155,147,96.0,3.04,1,0,illinois_institute_of_technology,reject,97
303,163,140,81.0,2.77,8,0,illinois_institute_of_technology,reject,97
320,166,154,102.0,2.85,18,0,illinois_institute_of_technology,reject,97
300,163,137,80.0,3.4,3,0,illinois_institute_of_technology,reject,97
313,160,153,109.0,1.85,30,3,illinois_institute_of_technology,reject,97
302,160,142,92.0,2.81,16,0,illinois_institute_of_technology,reject,97
301,162,139,65.0,3.27,0,3,illinois_institute_of_technology,reject,97
300,154,146,89.0,2.45,36,3,illinois_institute_of_technology,reject,97
308,159,149,96.0,2.88,32,0,illinois_institute_of_technology,reject,97
297,154,143,0,2.84,14,3,illinois_institute_of_technology,reject,97
307,158,149,105.0,2.72,10,3,illinois_institute_of_technology,reject,97
325,166,159,111.0,2.7,30,0,illinois_institute_of_technology,reject,97
325,166,159,111.0,2.7,30,0,illinois_institute_of_technology,reject,97
297,156,141,82.0,1.9,19,0,illinois_institute_of_technology,reject,97
310,158,152,97.0,2.48,48,3,illinois_institute_of_technology,reject,97
312,158,154,109.0,2.53,50,0,illinois_institute_of_technology,reject,97
305,164,141,101,3.15,12,0,illinois_institute_of_technology,reject,97
316,164,152,91.0,2.6,0,0,illinois_institute_of_technology,reject,97
316,164,152,91.0,2.6,0,0,illinois_institute_of_technology,reject,97
302,159,143,90.0,3.1,0,3,illinois_institute_of_technology,reject,97
291,151,140,78,2.8,0,0,illinois_institute_of_technology,reject,97
308,158,150,100.0,2.97,25,0,illinois_institute_of_technology,reject,97
318,153,165,101,3.05,0,0,illinois_institute_of_technology,reject,97
292,150,142,65.0,2.0,40,0,illinois_institute_of_technology,reject,97
295,160,135,78,3.06,0,0,illinois_institute_of_technology,reject,97
302,163,139,87.0,3.1,44,0,illinois_institute_of_technology,reject,97
301,156,145,89.0,2.95,2,0,illinois_institute_of_technology,reject,97
292,159,133,78,3.59,6,0,illinois_institute_of_technology,reject,97
308,162,146,101,2.78,0,0,illinois_institute_of_technology,reject,97
293,152,141,80.0,3.15,0,3,illinois_institute_of_technology,reject,97
298,159,139,77.0,3.11,0,0,illinois_institute_of_technology,reject,97
305,155,150,96.0,3.09,20,0,illinois_institute_of_technology,reject,97
306,158,148,106.0,2.98,24,2,illinois_institute_of_technology,reject,97
301,159,142,84.0,2.4,36,0,illinois_institute_of_technology,reject,97
304,158,146,101.0,2.23,30,0,illinois_institute_of_technology,reject,97
300,160,140,91.0,1.75,70,3,illinois_institute_of_technology,reject,97
315,152,163,105.0,2.1,25,3,illinois_institute_of_technology,reject,97
305,156,149,105.0,2.37,0,3,illinois_institute_of_technology,reject,97
305,156,149,105.0,2.37,0,3,illinois_institute_of_technology,reject,97
313,166,147,91.0,2.64,32,0,illinois_institute_of_technology,reject,97
303,159,144,95.0,2.72,9,0,illinois_institute_of_technology,reject,97
303,158,145,90.0,2.52,15,3,illinois_institute_of_technology,reject,97
294,153,141,83.0,2.18,78,0,illinois_institute_of_technology,reject,97
306,159,147,95.0,2.84,0,0,illinois_institute_of_technology,reject,97
310,159,151,107.0,3.08,0,0,illinois_institute_of_technology,reject,97
316,162,154,107.0,1.92,34,0,illinois_institute_of_technology,reject,97
304,156,148,96.0,2.38,1,3,illinois_institute_of_technology,reject,97
308,160,148,82.0,2.92,3,0,illinois_institute_of_technology,reject,97
296,151,145,84.0,3.28,0,2,illinois_institute_of_technology,reject,97
316,163,153,107.0,2.48,18,0,illinois_institute_of_technology,reject,97
305,159,146,85.0,2.55,10,0,illinois_institute_of_technology,reject,97
296,155,141,78,2.9,5,2,illinois_institute_of_technology,reject,97
315,167,148,99.0,2.82,8,3,illinois_institute_of_technology,reject,97
302,156,146,75.0,2.3,9,0,illinois_institute_of_technology,reject,97
308,159,149,97.0,2.47,32,0,illinois_institute_of_technology,reject,97
307,158,149,91.0,2.36,24,0,illinois_institute_of_technology,reject,97
311,161,150,103.0,3.1,6,2,illinois_institute_of_technology,reject,97
309,157,152,101.0,3.24,13,0,illinois_institute_of_technology,reject,97
320,169,151,106.0,3.01,25,0,illinois_institute_of_technology,reject,97
320,169,151,106.0,3.01,25,0,illinois_institute_of_technology,reject,97
319,168,151,98.0,2.68,20,0,illinois_institute_of_technology,reject,97
299,154,145,102.0,2.75,14,0,illinois_institute_of_technology,reject,97
302,162,140,65.0,2.66,0,3,illinois_institute_of_technology,reject,97
310,143,167,91.0,2.0,4,3,illinois_institute_of_technology,reject,97
315,160,155,114.0,2.28,12,0,illinois_institute_of_technology,reject,97
306,155,151,104.0,2.95,6,3,illinois_institute_of_technology,reject,97
308,160,148,89.0,2.74,42,0,illinois_institute_of_technology,reject,97
297,156,141,85.0,2.48,3,3,illinois_institute_of_technology,reject,97
315,161,154,107.0,2.02,60,0,illinois_institute_of_technology,reject,97
294,158,136,80.0,1.9,0,2,illinois_institute_of_technology,reject,97
306,159,147,105.0,2.56,0,0,illinois_institute_of_technology,reject,97
297,157,140,65.0,2.83,31,0,illinois_institute_of_technology,reject,97
303,158,145,96.0,2.1,49,0,illinois_institute_of_technology,reject,97
302,158,144,93.0,2.92,0,0,illinois_institute_of_technology,reject,97
294,153,141,80.0,3.08,0,3,illinois_institute_of_technology,reject,97
312,161,151,85.0,2.7,6,3,illinois_institute_of_technology,reject,97
294,153,141,81.0,2.46,24,3,illinois_institute_of_technology,reject,97
311,166,145,90.0,2.3,30,0,illinois_institute_of_technology,reject,97
299,157,142,99.0,2.72,15,3,illinois_institute_of_technology,reject,97
299,157,142,99.0,2.72,15,3,illinois_institute_of_technology,reject,97
308,159,149,114,2.19,12,0,illinois_institute_of_technology,reject,97
311,159,152,108.0,2.96,16,0,illinois_institute_of_technology,reject,97
308,160,148,85.0,3.08,0,0,illinois_institute_of_technology,reject,97
304,162,142,81.0,2.73,4,0,illinois_institute_of_technology,reject,97
312,162,150,99.0,2.72,6,0,illinois_institute_of_technology,reject,97
313,163,150,100.0,2.5,2,0,illinois_institute_of_technology,reject,97
313,158,155,104.0,2.63,28,0,illinois_institute_of_technology,reject,97
289,145,144,80.0,2.47,12,3,illinois_institute_of_technology,reject,97
298,153,145,87.0,2.81,0,0,illinois_institute_of_technology,reject,97
306,161,145,89.0,2.15,36,3,illinois_institute_of_technology,reject,97
293,154,139,65.0,2.8,16,0,illinois_institute_of_technology,reject,97
304,161,143,65.0,2.62,0,0,illinois_institute_of_technology,reject,97
304,160,144,87.0,3.04,3,0,illinois_institute_of_technology,reject,97
297,162,135,101,3.02,0,0,illinois_institute_of_technology,reject,97
296,150,146,101,3.0,18,0,illinois_institute_of_technology,reject,97
307,159,148,82.0,2.84,1,1,illinois_institute_of_technology,reject,97
317,165,152,96.0,2.86,34,0,indiana_university_bloomington,accept,48
317,165,152,96.0,2.86,34,0,indiana_university_bloomington,accept,48
305,156,149,98.0,3.12,5,0,indiana_university_bloomington,accept,48
320,163,157,113.0,3.77,0,2,indiana_university_bloomington,accept,48
315,164,151,109.0,3.28,1,0,indiana_university_bloomington,accept,48
314,163,151,108.0,1.88,54,2,indiana_university_bloomington,accept,48
304,158,146,95.0,3.4,20,0,indiana_university_bloomington,accept,48
309,157,152,104.0,2.6,14,0,indiana_university_bloomington,accept,48
317,163,154,110.0,2.65,5,3,indiana_university_bloomington,accept,48
323,170,153,100.0,3.02,1,3,indiana_university_bloomington,accept,48
316,165,151,108.0,3.56,0,0,indiana_university_bloomington,accept,48
316,164,152,107.0,3.44,3,0,indiana_university_bloomington,accept,48
306,157,149,100.0,3.56,20,0,indiana_university_bloomington,accept,48
326,167,159,110.0,2.68,29,0,indiana_university_bloomington,accept,48
318,166,152,96.0,2.68,28,0,indiana_university_bloomington,accept,48
315,160,155,102.0,3.35,3,0,indiana_university_bloomington,accept,48
314,163,151,91.0,2.55,24,0,indiana_university_bloomington,accept,48
310,161,149,100.0,2.92,4,0,indiana_university_bloomington,accept,48
323,164,159,110.0,3.12,12,0,indiana_university_bloomington,accept,48
316,166,150,104.0,2.64,27,0,indiana_university_bloomington,accept,48
316,166,150,104.0,2.64,27,0,indiana_university_bloomington,accept,48
321,168,153,113.0,3.6,1,2,indiana_university_bloomington,accept,48
313,164,149,108.0,2.35,21,0,indiana_university_bloomington,accept,48
314,164,150,109.0,3.4,0,1,indiana_university_bloomington,accept,48
323,170,153,113.0,3.28,2,3,indiana_university_bloomington,accept,48
306,160,146,112.0,2.5,18,0,indiana_university_bloomington,accept,48
318,163,155,102.0,2.7,18,0,indiana_university_bloomington,accept,48
320,167,153,101.0,2.93,48,0,indiana_university_bloomington,accept,48
312,160,152,102.0,3.15,0,0,indiana_university_bloomington,accept,48
318,170,148,102.0,2.8,4,0,indiana_university_bloomington,accept,48
318,164,154,112.0,2.98,14,0,indiana_university_bloomington,accept,48
322,170,152,110.0,3.08,8,3,indiana_university_bloomington,accept,48
315,165,150,108.0,2.99,0,0,indiana_university_bloomington,accept,48
319,170,149,97.0,3.24,5,0,indiana_university_bloomington,accept,48
328,170,158,114.0,2.99,17,0,indiana_university_bloomington,accept,48
322,170,152,101.0,3.21,15,0,indiana_university_bloomington,accept,48
318,169,149,109.0,3.48,0,0,indiana_university_bloomington,accept,48
325,166,159,110.0,3.24,13,0,indiana_university_bloomington,accept,48
329,168,161,109.0,3.48,2,3,indiana_university_bloomington,accept,48
329,168,161,109.0,3.48,2,3,indiana_university_bloomington,accept,48
312,165,147,101.0,3.36,4,0,indiana_university_bloomington,accept,48
313,161,152,106.0,3.28,41,1,indiana_university_bloomington,accept,48
321,167,154,109.0,3.0,0,0,indiana_university_bloomington,accept,48
308,156,152,102.0,3.06,7,3,indiana_university_bloomington,accept,48
307,161,146,101.0,3.62,36,0,indiana_university_bloomington,accept,48
316,161,155,111.0,3.04,0,3,indiana_university_bloomington,accept,48
317,168,149,104.0,3.06,19,0,indiana_university_bloomington,accept,48
324,166,158,105.0,2.62,1,0,indiana_university_bloomington,accept,48
315,168,147,91.0,2.9,0,0,indiana_university_bloomington,accept,48
318,160,158,107.0,3.56,0,0,indiana_university_bloomington,accept,48
324,165,159,115.0,3.3,0,0,indiana_university_bloomington,accept,48
323,168,155,104.0,3.09,3,0,indiana_university_bloomington,accept,48
322,167,155,110.0,3.56,4,2,indiana_university_bloomington,accept,48
324,162,162,109.0,3.4,19,0,indiana_university_bloomington,accept,48
307,162,145,96.0,2.74,25,0,indiana_university_bloomington,accept,48
315,164,151,109.0,3.08,32,0,indiana_university_bloomington,accept,48
310,159,151,91.0,3.26,1,0,indiana_university_bloomington,accept,48
310,166,144,98.0,3.16,33,0,indiana_university_bloomington,accept,48
314,161,153,108.0,3.38,17,3,indiana_university_bloomington,accept,48
314,161,153,108.0,3.38,17,3,indiana_university_bloomington,accept,48
311,163,148,101,3.12,30,0,indiana_university_bloomington,accept,48
317,168,149,100.0,3.52,1,0,indiana_university_bloomington,accept,48
315,160,155,105.0,3.24,30,0,indiana_university_bloomington,accept,48
321,164,157,105.0,2.65,9,1,indiana_university_bloomington,accept,48
317,163,154,109.0,2.45,28,0,indiana_university_bloomington,accept,48
319,168,151,106.0,2.05,38,0,indiana_university_bloomington,accept,48
304,154,150,97.0,3.8,26,3,indiana_university_bloomington,accept,48
324,167,157,101.0,3.4,1,0,indiana_university_bloomington,accept,48
318,162,156,104.0,3.36,33,0,indiana_university_bloomington,accept,48
332,170,162,106.0,3.01,16,0,indiana_university_bloomington,accept,48
313,162,151,113.0,3.5,6,0,indiana_university_bloomington,accept,48
314,165,149,105.0,3.49,19,0,indiana_university_bloomington,accept,48
314,164,150,103.0,3.2,3,1,indiana_university_bloomington,accept,48
309,161,148,100.0,2.62,60,0,indiana_university_bloomington,accept,48
312,160,152,113.0,3.06,48,3,indiana_university_bloomington,accept,48
310,159,151,101.0,3.5,0,3,indiana_university_bloomington,accept,48
320,167,153,106.0,2.98,32,3,indiana_university_bloomington,accept,48
320,167,153,106.0,2.98,32,3,indiana_university_bloomington,accept,48
319,164,155,108.0,3.28,30,0,indiana_university_bloomington,accept,48
316,166,150,100.0,3.47,9,3,indiana_university_bloomington,accept,48
311,159,152,105.0,3.13,0,0,indiana_university_bloomington,accept,48
304,155,149,83.0,3.08,0,0,indiana_university_bloomington,accept,48
316,165,151,100.0,3.6,40,0,indiana_university_bloomington,accept,48
323,168,155,109.0,3.19,24,3,indiana_university_bloomington,accept,48
315,162,153,101,3.2,60,3,indiana_university_bloomington,accept,48
307,156,151,95.0,3.0,60,0,indiana_university_bloomington,accept,48
320,165,155,105.0,3.2,1,0,indiana_university_bloomington,accept,48
319,164,155,0,3.11,20,0,indiana_university_bloomington,accept,48
315,166,149,104.0,2.91,21,3,indiana_university_bloomington,accept,48
320,164,156,114.0,3.05,2,0,indiana_university_bloomington,accept,48
315,166,149,101.0,2.1,27,0,indiana_university_bloomington,accept,48
318,164,154,109.0,2.17,1,0,indiana_university_bloomington,accept,48
315,164,151,0,2.3,30,0,indiana_university_bloomington,accept,48
319,166,153,0,2.5,2,0,indiana_university_bloomington,accept,48
319,161,158,0,2.54,31,0,indiana_university_bloomington,accept,48
314,162,152,106.0,3.36,6,0,indiana_university_bloomington,accept,48
314,162,152,106.0,3.36,6,0,indiana_university_bloomington,accept,48
320,162,158,0,2.8,31,0,indiana_university_bloomington,accept,48
314,168,146,102.0,2.77,24,0,indiana_university_bloomington,accept,48
304,162,142,88.0,2.2,15,0,indiana_university_bloomington,accept,48
322,167,155,107.0,2.21,0,0,indiana_university_bloomington,accept,48
311,168,143,108.0,3.56,36,0,indiana_university_bloomington,accept,48
313,163,150,96.0,3.44,28,0,indiana_university_bloomington,accept,48
320,160,160,0,3.01,0,0,indiana_university_bloomington,accept,48
307,161,146,101.0,3.32,20,0,indiana_university_bloomington,accept,48
324,167,157,110.0,3.62,0,3,indiana_university_bloomington,accept,48
322,168,154,111.0,2.96,16,3,indiana_university_bloomington,accept,48
320,162,158,112.0,3.02,28,0,indiana_university_bloomington,accept,48
312,165,147,101,3.15,0,0,indiana_university_bloomington,accept,48
317,160,157,114.0,2.39,16,0,indiana_university_bloomington,accept,48
313,161,152,102.0,3.05,0,0,indiana_university_bloomington,accept,48
306,160,146,96.0,3.33,28,0,indiana_university_bloomington,accept,48
310,160,150,98.0,2.88,14,3,indiana_university_bloomington,accept,48
320,168,152,106.0,2.92,17,0,indiana_university_bloomington,accept,48
319,162,157,107.0,2.75,90,0,indiana_university_bloomington,accept,48
322,165,157,111.0,2.15,20,0,indiana_university_bloomington,accept,48
322,165,157,111.0,2.15,20,0,indiana_university_bloomington,accept,48
314,164,150,108.0,3.44,30,0,indiana_university_bloomington,accept,48
305,158,147,96.0,2.86,15,2,indiana_university_bloomington,accept,48
305,159,146,91.0,2.51,60,0,indiana_university_bloomington,accept,48
316,162,154,102.0,2.4,24,3,indiana_university_bloomington,accept,48
311,164,147,99.0,2.43,27,3,indiana_university_bloomington,accept,48
324,169,155,112.0,3.1,14,0,indiana_university_bloomington,accept,48
315,165,150,102.0,3.1,8,0,indiana_university_bloomington,accept,48
320,167,153,0,3.04,1,2,indiana_university_bloomington,accept,48
325,170,155,105.0,2.66,48,0,indiana_university_bloomington,accept,48
310,161,149,112.0,3.4,25,0,indiana_university_bloomington,accept,48
305,155,150,101,2.65,24,2,indiana_university_bloomington,accept,48
319,167,152,94.0,3.35,0,0,indiana_university_bloomington,accept,48
301,161,140,101,2.7,0,0,indiana_university_bloomington,accept,48
331,167,164,117.0,3.68,28,0,indiana_university_bloomington,accept,48
315,163,152,92.0,3.04,26,0,indiana_university_bloomington,accept,48
317,151,166,108.0,3.2,2,0,indiana_university_bloomington,accept,48
319,164,155,112.0,2.6,5,0,indiana_university_bloomington,accept,48
314,164,150,0,3.24,20,0,indiana_university_bloomington,accept,48
316,161,155,108.0,2.95,27,0,indiana_university_bloomington,accept,48
316,161,155,108.0,2.95,27,0,indiana_university_bloomington,accept,48
311,160,151,111.0,2.49,26,2,indiana_university_bloomington,accept,48
314,164,150,101,2.46,18,0,indiana_university_bloomington,accept,48
313,162,151,103.0,2.55,38,0,indiana_university_bloomington,accept,48
319,154,165,105.0,2.1,0,0,indiana_university_bloomington,accept,48
314,163,151,109.0,2.82,0,0,indiana_university_bloomington,accept,48
311,166,145,98.0,2.15,0,0,indiana_university_bloomington,accept,48
315,162,153,111.0,3.15,0,0,indiana_university_bloomington,accept,48
302,155,147,109.0,2.9,0,0,indiana_university_bloomington,accept,48
299,157,142,97.0,2.22,0,0,indiana_university_bloomington,accept,48
323,159,164,116.0,2.5,0,0,indiana_university_bloomington,accept,48
323,161,162,110.0,2.55,0,0,indiana_university_bloomington,accept,48
307,156,151,94.0,3.3,0,0,indiana_university_bloomington,accept,48
316,164,152,108.0,2.02,0,3,indiana_university_bloomington,accept,48
313,158,155,116.0,2.63,5,3,indiana_university_bloomington,accept,48
308,161,147,90.0,3.36,54,0,indiana_university_bloomington,accept,48
316,164,152,108.0,2.02,0,3,indiana_university_bloomington,accept,48
313,158,155,116.0,2.63,5,3,indiana_university_bloomington,accept,48
308,161,147,90.0,3.36,54,0,indiana_university_bloomington,accept,48
310,165,145,92.0,3.16,60,0,indiana_university_bloomington,accept,48
310,165,145,92.0,3.16,60,0,indiana_university_bloomington,accept,48
318,170,148,97.0,3.26,22,0,indiana_university_bloomington,accept,48
313,165,148,98.0,2.92,9,3,indiana_university_bloomington,accept,48
319,160,159,107.0,3.48,13,0,indiana_university_bloomington,accept,48
316,159,157,106.0,2.9,13,0,indiana_university_bloomington,accept,48
316,162,154,104.0,3.21,0,3,indiana_university_bloomington,accept,48
315,163,152,103.0,3.75,3,2,indiana_university_bloomington,accept,48
328,170,158,104.0,2.72,45,0,indiana_university_bloomington,accept,48
307,158,149,107.0,2.28,40,0,indiana_university_bloomington,accept,48
314,158,156,112.0,3.79,17,0,indiana_university_bloomington,accept,48
308,157,151,96.0,2.5,34,0,indiana_university_bloomington,accept,48
310,161,149,97.0,3.42,2,3,indiana_university_bloomington,accept,48
317,165,152,107.0,3.1,0,0,indiana_university_bloomington,accept,48
323,164,159,113.0,3.4,3,0,indiana_university_bloomington,accept,48
305,159,146,96.0,2.5,60,0,indiana_university_bloomington,accept,48
311,165,146,94.0,3.36,15,0,indiana_university_bloomington,accept,48
308,162,146,89.0,3.12,21,0,indiana_university_bloomington,accept,48
319,164,155,101.0,2.3,19,2,indiana_university_bloomington,accept,48
303,157,146,97.0,3.17,21,0,indiana_university_bloomington,accept,48
315,167,148,93.0,3.25,26,0,indiana_university_bloomington,accept,48
315,167,148,93.0,3.25,26,0,indiana_university_bloomington,accept,48
311,161,150,95.0,3.1,17,0,indiana_university_bloomington,accept,48
307,163,144,0,3.33,15,0,indiana_university_bloomington,accept,48
311,157,154,103.0,3.25,10,0,indiana_university_bloomington,accept,48
316,163,153,104.0,1.3,60,0,indiana_university_bloomington,accept,48
320,168,152,114,3.22,12,3,indiana_university_bloomington,accept,48
316,166,150,92.0,3.16,30,3,indiana_university_bloomington,accept,48
315,161,154,109.0,3.02,14,1,indiana_university_bloomington,accept,48
310,161,149,103.0,2.38,24,0,indiana_university_bloomington,accept,48
305,156,149,91.0,3.19,18,3,indiana_university_bloomington,accept,48
318,165,153,109.0,2.05,55,0,indiana_university_bloomington,accept,48
329,167,162,117.0,3.08,36,0,indiana_university_bloomington,accept,48
307,160,147,85.0,3.17,14,0,indiana_university_bloomington,accept,48
308,160,148,93.0,3.42,0,0,indiana_university_bloomington,accept,48
316,170,146,100.0,3.2,25,0,indiana_university_bloomington,accept,48
312,158,154,105.0,2.1,0,3,indiana_university_bloomington,accept,48
304,156,148,96.0,2.85,30,0,indiana_university_bloomington,accept,48
309,161,148,102.0,2.9,30,0,indiana_university_bloomington,accept,48
314,157,157,103.0,2.15,0,0,indiana_university_bloomington,accept,48
310,155,155,102.0,3.76,60,0,indiana_university_bloomington,accept,48
313,161,152,107.0,2.2,30,3,indiana_university_bloomington,accept,48
329,169,160,105.0,2.8,32,0,indiana_university_bloomington,accept,48
315,165,150,110.0,2.81,40,0,indiana_university_bloomington,accept,48
310,160,150,103.0,3.45,40,0,indiana_university_bloomington,accept,48
313,158,155,110.0,2.45,30,2,indiana_university_bloomington,accept,48
307,161,146,102.0,3.64,30,0,indiana_university_bloomington,accept,48
322,170,152,109.0,3.86,6,0,indiana_university_bloomington,accept,48
308,159,149,108.0,2.5,0,0,indiana_university_bloomington,accept,48
314,161,153,106.0,2.35,30,0,indiana_university_bloomington,accept,48
321,170,151,109.0,3.16,56,3,indiana_university_bloomington,accept,48
303,159,144,97.0,3.0,15,0,indiana_university_bloomington,accept,48
300,156,144,102.0,2.88,0,3,indiana_university_bloomington,accept,48
313,165,148,107.0,3.1,25,0,indiana_university_bloomington,accept,48
320,162,158,112.0,2.72,6,0,indiana_university_bloomington,accept,48
320,162,158,112.0,2.72,6,0,indiana_university_bloomington,accept,48
296,152,144,65.0,2.33,36,1,indiana_university_bloomington,accept,48
326,170,156,107.0,3.2,30,0,indiana_university_bloomington,accept,48
311,160,151,103.0,3.29,36,0,indiana_university_bloomington,accept,48
315,163,152,106.0,3.1,22,0,indiana_university_bloomington,accept,48
321,166,155,108.0,2.9,48,0,indiana_university_bloomington,accept,48
307,161,146,99.0,3.51,47,0,indiana_university_bloomington,accept,48
320,167,153,108.0,2.49,19,0,indiana_university_bloomington,accept,48
311,158,153,104.0,3.39,66,0,indiana_university_bloomington,accept,48
311,161,150,105.0,3.28,30,0,indiana_university_bloomington,accept,48
316,170,146,105.0,3.08,36,3,indiana_university_bloomington,accept,48
321,167,154,108.0,2.7,10,0,indiana_university_bloomington,accept,48
319,164,155,109.0,3.16,0,0,indiana_university_bloomington,accept,48
326,169,157,113.0,3.92,2,3,indiana_university_bloomington,accept,48
321,161,160,113.0,3.02,0,0,indiana_university_bloomington,accept,48
316,164,152,107.0,3.76,0,0,indiana_university_bloomington,accept,48
326,169,157,101,3.68,48,3,indiana_university_bloomington,accept,48
320,168,152,109.0,3.12,0,0,indiana_university_bloomington,accept,48
306,161,145,94.0,2.25,16,3,indiana_university_bloomington,accept,48
310,160,150,94.0,3.24,0,3,indiana_university_bloomington,accept,48
310,160,150,94.0,3.24,0,3,indiana_university_bloomington,accept,48
310,165,145,100.0,2.15,22,3,indiana_university_bloomington,accept,48
309,159,150,102.0,2.2,30,0,indiana_university_bloomington,accept,48
320,167,153,108.0,2.55,28,1,indiana_university_bloomington,accept,48
315,164,151,98.0,2.98,44,0,indiana_university_bloomington,accept,48
315,163,152,111.0,2.35,23,3,indiana_university_bloomington,accept,48
308,161,147,102.0,3.49,48,0,indiana_university_bloomington,accept,48
306,160,146,101.0,3.39,0,0,indiana_university_bloomington,accept,48
314,163,151,104.0,2.1,26,0,indiana_university_bloomington,accept,48
317,163,154,110.0,2.75,36,0,indiana_university_bloomington,accept,48
322,165,157,110.0,3.44,0,0,indiana_university_bloomington,accept,48
306,159,147,103.0,3.28,10,0,indiana_university_bloomington,accept,48
315,162,153,111.0,2.7,9,2,indiana_university_bloomington,accept,48
316,163,153,101.0,2.6,0,0,indiana_university_bloomington,accept,48
312,162,150,103.0,2.56,0,0,indiana_university_bloomington,accept,48
310,164,146,85.0,2.53,6,0,indiana_university_bloomington,accept,48
309,161,148,98.0,3.48,1,0,indiana_university_bloomington,accept,48
317,155,162,105.0,2.25,58,0,indiana_university_bloomington,accept,48
310,160,150,97.0,3.22,30,0,indiana_university_bloomington,accept,48
303,160,143,96.0,3.17,0,0,indiana_university_bloomington,accept,48
309,162,147,103.0,2.68,21,3,indiana_university_bloomington,accept,48
309,162,147,103.0,2.68,21,3,indiana_university_bloomington,accept,48
308,160,148,103.0,3.07,0,0,indiana_university_bloomington,accept,48
306,159,147,103.0,2.51,32,2,indiana_university_bloomington,accept,48
311,160,151,107.0,2.7,57,0,indiana_university_bloomington,accept,48
307,157,150,100.0,2.5,75,0,indiana_university_bloomington,accept,48
314,161,153,106.0,2.45,0,0,indiana_university_bloomington,accept,48
314,163,151,106.0,2.3,24,0,indiana_university_bloomington,accept,48
312,165,147,107.0,3.47,31,0,indiana_university_bloomington,accept,48
315,162,153,101,3.2,30,0,indiana_university_bloomington,accept,48
307,156,151,101.0,3.62,0,0,indiana_university_bloomington,accept,48
313,158,155,112.0,2.78,0,0,indiana_university_bloomington,accept,48
307,157,150,104.0,3.48,24,0,indiana_university_bloomington,accept,48
316,161,155,108.0,3.51,0,0,indiana_university_bloomington,accept,48
321,164,157,104.0,2.23,72,0,indiana_university_bloomington,accept,48
313,161,152,112.0,3.15,36,0,indiana_university_bloomington,accept,48
320,167,153,109.0,3.64,2,0,indiana_university_bloomington,accept,48
312,163,149,102.0,3.77,0,0,indiana_university_bloomington,accept,48
308,161,147,104.0,2.43,24,3,indiana_university_bloomington,accept,48
311,161,150,106.0,2.4,20,0,indiana_university_bloomington,accept,48
321,165,156,103.0,2.0,20,0,indiana_university_bloomington,accept,48
326,162,164,113.0,2.0,18,3,indiana_university_bloomington,reject,48
326,162,164,113.0,2.0,18,3,indiana_university_bloomington,reject,48
319,169,150,103.0,2.88,27,0,indiana_university_bloomington,reject,48
321,167,154,105.0,1.8,29,3,indiana_university_bloomington,reject,48
313,157,156,108.0,1.75,18,0,indiana_university_bloomington,reject,48
308,157,151,101.0,3.18,0,1,indiana_university_bloomington,reject,48
312,160,152,0,2.47,20,0,indiana_university_bloomington,reject,48
316,169,147,96.0,3.05,0,0,indiana_university_bloomington,reject,48
314,164,150,90.0,2.58,2,0,indiana_university_bloomington,reject,48
331,164,167,114.0,2.75,19,0,indiana_university_bloomington,reject,48
314,160,154,107.0,2.11,15,3,indiana_university_bloomington,reject,48
308,156,152,104.0,3.35,30,0,indiana_university_bloomington,reject,48
319,166,153,102.0,2.52,0,0,indiana_university_bloomington,reject,48
317,163,154,118.0,3.0,0,0,indiana_university_bloomington,reject,48
320,160,160,113.0,2.35,19,0,indiana_university_bloomington,reject,48
313,166,147,97.0,3.32,0,0,indiana_university_bloomington,reject,48
317,165,152,101.0,2.3,0,0,indiana_university_bloomington,reject,48
313,160,153,95.0,2.35,40,0,indiana_university_bloomington,reject,48
310,166,144,92.0,3.44,0,0,indiana_university_bloomington,reject,48
308,159,149,107.0,3.24,0,0,indiana_university_bloomington,reject,48
323,170,153,103.0,2.4,0,0,indiana_university_bloomington,reject,48
314,165,149,98.0,3.1,26,0,indiana_university_bloomington,reject,48
314,165,149,98.0,3.1,26,0,indiana_university_bloomington,reject,48
307,159,148,96.0,2.55,0,0,indiana_university_bloomington,reject,48
298,154,144,88.0,2.9,36,0,indiana_university_bloomington,reject,48
311,163,148,94.0,3.0,27,0,indiana_university_bloomington,reject,48
310,160,150,99.0,3.28,27,0,indiana_university_bloomington,reject,48
312,158,154,115.0,3.28,9,0,indiana_university_bloomington,reject,48
325,163,162,112.0,2.8,0,0,indiana_university_bloomington,reject,48
315,162,153,106.0,3.19,4,0,indiana_university_bloomington,reject,48
310,162,148,99.0,2.1,0,0,indiana_university_bloomington,reject,48
320,166,154,112.0,2.27,16,3,indiana_university_bloomington,reject,48
321,168,153,113.0,2.64,2,0,indiana_university_bloomington,reject,48
301,162,139,65.0,3.08,22,2,indiana_university_bloomington,reject,48
308,154,154,96.0,2.25,30,1,indiana_university_bloomington,reject,48
308,157,151,90.0,2.7,24,0,indiana_university_bloomington,reject,48
319,160,159,109.0,2.3,7,0,indiana_university_bloomington,reject,48
303,157,146,90.0,3.6,29,0,indiana_university_bloomington,reject,48
303,160,143,85.0,3.2,30,3,indiana_university_bloomington,reject,48
315,167,148,88.0,2.65,25,0,indiana_university_bloomington,reject,48
312,158,154,105.0,2.58,0,0,indiana_university_bloomington,reject,48
311,161,150,103.0,3.03,10,3,indiana_university_bloomington,reject,48
311,161,150,103.0,3.03,10,3,indiana_university_bloomington,reject,48
317,158,159,105.0,2.1,40,0,indiana_university_bloomington,reject,48
312,161,151,99.0,2.8,30,0,indiana_university_bloomington,reject,48
315,166,149,96.0,2.95,18,0,indiana_university_bloomington,reject,48
310,155,155,100.0,1.95,0,1,indiana_university_bloomington,reject,48
324,167,157,110.0,1.78,12,3,indiana_university_bloomington,reject,48
313,165,148,101.0,2.56,50,0,indiana_university_bloomington,reject,48
305,155,150,75.0,2.78,42,0,indiana_university_bloomington,reject,48
304,157,147,99.0,2.65,20,0,indiana_university_bloomington,reject,48
319,170,149,96.0,2.72,5,0,indiana_university_bloomington,reject,48
311,160,151,106.0,3.46,30,3,indiana_university_bloomington,reject,48
316,154,162,113.0,3.22,30,0,indiana_university_bloomington,reject,48
308,158,150,100.0,2.1,0,0,indiana_university_bloomington,reject,48
315,164,151,106.0,1.95,20,0,indiana_university_bloomington,reject,48
308,163,145,103.0,2.5,0,0,indiana_university_bloomington,reject,48
324,162,162,85.0,3.18,30,0,indiana_university_bloomington,reject,48
305,157,148,103.0,2.02,0,3,indiana_university_bloomington,reject,48
312,170,142,97.0,3.21,12,2,indiana_university_bloomington,reject,48
310,160,150,110.0,3.0,10,0,indiana_university_bloomington,reject,48
319,159,160,109.0,3.44,20,0,indiana_university_bloomington,reject,48
316,169,147,96.0,3.05,0,0,indiana_university_bloomington,reject,48
316,169,147,96.0,3.05,0,0,indiana_university_bloomington,reject,48
307,158,149,90.0,2.9,0,3,indiana_university_bloomington,reject,48
311,163,148,91.0,2.6,30,1,indiana_university_bloomington,reject,48
320,168,152,94.0,2.55,30,3,indiana_university_bloomington,reject,48
305,153,152,106.0,2.05,30,3,indiana_university_bloomington,reject,48
308,161,147,99.0,3.19,0,0,indiana_university_bloomington,reject,48
310,158,152,116.0,2.0,0,0,indiana_university_bloomington,reject,48
321,168,153,114.0,2.45,0,0,indiana_university_bloomington,reject,48
301,156,145,95.0,2.75,20,3,indiana_university_bloomington,reject,48
308,162,146,107.0,2.57,38,0,kansas_state_university,accept,115
308,162,146,107.0,2.57,38,0,kansas_state_university,accept,115
310,166,144,97.0,2.12,1,0,kansas_state_university,accept,115
303,160,143,65.0,3.02,6,0,kansas_state_university,accept,115
309,163,146,75.0,2.9,30,0,kansas_state_university,accept,115
329,163,166,104.0,2.85,10,2,kansas_state_university,accept,115
317,160,157,114,2.65,0,0,kansas_state_university,accept,115
326,162,164,113.0,2.0,18,3,kansas_state_university,accept,115
307,157,150,101,2.4,0,3,kansas_state_university,accept,115
303,155,148,75.0,2.25,0,0,kansas_state_university,accept,115
304,164,140,101,3.82,12,0,kansas_state_university,accept,115
300,161,139,101,2.88,0,0,kansas_state_university,accept,115
315,164,151,107.0,3.31,29,0,kansas_state_university,accept,115
312,165,147,0,2.8,30,3,kansas_state_university,accept,115
310,164,146,91.0,2.2,42,0,kansas_state_university,accept,115
309,159,150,75.0,2.88,14,0,kansas_state_university,accept,115
317,170,147,95.0,3.37,0,0,kansas_state_university,accept,115
308,162,146,97.0,2.81,23,0,kansas_state_university,accept,115
309,158,151,101.0,2.86,19,0,kansas_state_university,accept,115
309,158,151,101.0,2.86,19,0,kansas_state_university,accept,115
307,163,144,93.0,3.31,18,0,kansas_state_university,accept,115
323,164,159,109.0,2.79,5,0,kansas_state_university,accept,115
300,158,142,75.0,2.5,13,3,kansas_state_university,accept,115
310,162,148,91.0,3.05,25,0,kansas_state_university,accept,115
307,155,152,107.0,2.49,6,0,kansas_state_university,accept,115
314,166,148,93.0,3.32,0,0,kansas_state_university,accept,115
304,160,144,101,3.47,1,0,kansas_state_university,accept,115
319,161,158,116.0,3.65,14,3,kansas_state_university,accept,115
320,167,153,113.0,3.35,0,0,kansas_state_university,accept,115
300,160,140,90.0,2.5,36,0,kansas_state_university,accept,115
314,161,153,102.0,2.8,0,0,kansas_state_university,accept,115
326,170,156,102.0,2.98,0,0,kansas_state_university,accept,115
312,166,146,90.0,3.94,10,0,kansas_state_university,accept,115
313,162,151,96.0,2.86,0,0,kansas_state_university,accept,115
313,163,150,106.0,2.85,0,0,kansas_state_university,accept,115
306,163,143,101,3.83,3,0,kansas_state_university,accept,115
316,162,154,107.0,3.0,20,0,kansas_state_university,accept,115
314,166,148,107.0,2.8,0,0,kansas_state_university,accept,115
326,170,156,102.0,2.98,0,0,kansas_state_university,accept,115
326,170,156,102.0,2.98,0,0,kansas_state_university,accept,115
286,147,139,45,2.5,0,0,kansas_state_university,accept,115
307,160,147,92.0,2.75,0,0,kansas_state_university,accept,115
321,168,153,105.0,2.52,0,0,kansas_state_university,accept,115
300,159,141,110.0,3.55,1,0,kansas_state_university,accept,115
312,163,149,105.0,2.35,0,0,kansas_state_university,reject,115
312,163,149,105.0,2.35,0,0,kansas_state_university,reject,115
308,157,151,95.0,2.55,1,0,kansas_state_university,reject,115
302,161,141,88.0,3.22,21,0,kansas_state_university,reject,115
307,159,148,93.0,2.98,15,3,kansas_state_university,reject,115
300,161,139,75.0,2.68,12,0,kansas_state_university,reject,115
302,163,139,101,2.1,36,0,kansas_state_university,reject,115
314,165,149,90.0,3.2,3,0,kansas_state_university,reject,115
310,162,148,65.0,3.2,18,0,kansas_state_university,reject,115
307,164,143,65.0,2.85,41,0,kansas_state_university,reject,115
302,162,140,82.0,3.68,0,0,kansas_state_university,reject,115
306,155,151,115.0,3.1,0,0,kansas_state_university,reject,115
304,158,146,101,2.45,0,0,kansas_state_university,reject,115
322,170,152,101.0,2.74,0,3,kansas_state_university,reject,115
295,158,137,101,3.05,38,3,kansas_state_university,reject,115
306,160,146,88.0,3.28,18,0,kansas_state_university,reject,115
307,155,152,104.0,1.95,5,3,kansas_state_university,reject,115
301,158,143,86.0,3.4,0,0,kansas_state_university,reject,115
304,158,146,85.0,2.45,90,0,kansas_state_university,reject,115
302,156,146,101.0,2.14,0,0,kansas_state_university,reject,115
309,164,145,78,2.7,24,0,kansas_state_university,reject,115
309,164,145,78,2.7,24,0,kansas_state_university,reject,115
302,153,149,98.0,2.0,52,0,kansas_state_university,reject,115
309,160,149,89.0,3.44,21,0,kansas_state_university,reject,115
315,163,152,100.0,2.92,20,0,kansas_state_university,reject,115
315,163,152,100.0,2.92,20,0,kansas_state_university,reject,115
293,154,139,75.0,2.4,0,2,kansas_state_university,reject,115
322,168,154,107.0,2.7,0,0,kansas_state_university,reject,115
292,144,148,81.0,2.45,10,1,kansas_state_university,reject,115
317,163,154,97.0,2.6,10,0,kansas_state_university,reject,115
318,166,152,101,3.05,30,0,kansas_state_university,reject,115
312,160,152,101,3.01,0,0,kansas_state_university,reject,115
320,162,158,106.0,3.08,23,0,university_of_maryland_college_park,accept,10
334,169,165,114.0,3.92,0,0,university_of_maryland_college_park,accept,10
320,166,154,104.0,3.23,3,3,university_of_maryland_college_park,accept,10
314,163,151,104.0,3.9,26,2,university_of_maryland_college_park,accept,10
332,169,163,116.0,3.16,2,0,university_of_maryland_college_park,accept,10
314,163,151,104.0,3.75,15,3,university_of_maryland_college_park,accept,10
327,168,159,114.0,3.75,5,3,university_of_maryland_college_park,accept,10
322,169,153,112.0,3.88,20,3,university_of_maryland_college_park,accept,10
302,160,142,102.0,3.82,30,3,university_of_maryland_college_park,accept,10
322,170,152,106.0,3.72,6,0,university_of_maryland_college_park,accept,10
324,167,157,108.0,3.12,6,2,university_of_maryland_college_park,accept,10
334,169,165,114.0,3.92,0,0,university_of_maryland_college_park,accept,10
320,166,154,104.0,3.23,3,3,university_of_maryland_college_park,accept,10
324,168,156,114.0,3.69,12,3,university_of_maryland_college_park,accept,10
332,169,163,116.0,3.16,2,0,university_of_maryland_college_park,accept,10
314,163,151,104.0,3.75,15,3,university_of_maryland_college_park,accept,10
323,157,166,113.0,3.56,20,3,university_of_maryland_college_park,accept,10
327,168,159,114.0,3.75,5,3,university_of_maryland_college_park,accept,10
320,166,154,103.0,2.5,0,0,university_of_maryland_college_park,accept,10
302,160,142,102.0,3.82,30,3,university_of_maryland_college_park,accept,10
322,170,152,106.0,3.72,6,0,university_of_maryland_college_park,accept,10
316,160,156,108.0,2.29,47,0,university_of_maryland_college_park,accept,10
322,160,162,105.0,3.6,0,2,university_of_maryland_college_park,accept,10
315,165,150,104.0,2.95,26,0,university_of_maryland_college_park,accept,10
321,170,151,0,3.72,18,0,university_of_maryland_college_park,accept,10
322,162,160,112.0,3.57,12,0,university_of_maryland_college_park,accept,10
331,168,163,117.0,3.87,6,3,university_of_maryland_college_park,accept,10
303,158,145,95.0,3.04,0,0,university_of_maryland_college_park,accept,10
319,162,157,104.0,3.6,0,0,university_of_maryland_college_park,accept,10
330,165,165,100.0,3.2,24,3,university_of_maryland_college_park,accept,10
322,170,152,113.0,3.66,6,3,university_of_maryland_college_park,accept,10
321,167,154,109.0,3.3,18,3,university_of_maryland_college_park,accept,10
321,163,158,116.0,3.16,29,0,university_of_maryland_college_park,reject,10
321,163,158,116.0,3.16,29,0,university_of_maryland_college_park,reject,10
319,164,155,85.0,3.17,23,0,university_of_maryland_college_park,reject,10
315,161,154,105.0,2.95,2,2,university_of_maryland_college_park,reject,10
315,161,154,111.0,3.0,26,0,university_of_maryland_college_park,reject,10
327,168,159,109.0,3.46,14,0,university_of_maryland_college_park,reject,10
317,165,152,105.0,3.5,20,0,university_of_maryland_college_park,reject,10
307,157,150,93.0,3.05,25,0,university_of_maryland_college_park,reject,10
319,164,155,104.0,3.35,5,3,university_of_maryland_college_park,reject,10
317,165,152,110.0,3.87,16,3,university_of_maryland_college_park,reject,10
329,167,162,116.0,2.75,13,0,university_of_maryland_college_park,reject,10
313,163,150,101.0,3.6,60,2,university_of_maryland_college_park,reject,10
318,167,151,109.0,3.88,2,0,university_of_maryland_college_park,reject,10
323,170,153,100.0,3.02,1,3,university_of_maryland_college_park,reject,10
321,163,158,116.0,3.16,29,0,university_of_maryland_college_park,reject,10
321,163,158,116.0,3.16,29,0,university_of_maryland_college_park,reject,10
324,165,159,113.0,2.51,28,0,university_of_maryland_college_park,reject,10
307,157,150,93.0,3.05,25,0,university_of_maryland_college_park,reject,10
319,164,155,104.0,3.35,5,3,university_of_maryland_college_park,reject,10
316,166,150,94.0,3.09,6,0,university_of_maryland_college_park,reject,10
329,167,162,116.0,2.75,13,0,university_of_maryland_college_park,reject,10
313,163,150,101,3.0,18,0,university_of_maryland_college_park,reject,10
318,167,151,109.0,3.88,2,0,university_of_maryland_college_park,reject,10
323,170,153,100.0,3.02,1,3,university_of_maryland_college_park,reject,10
316,165,151,108.0,3.56,0,0,university_of_maryland_college_park,reject,10
321,170,151,111.0,3.63,17,0,university_of_maryland_college_park,reject,10
320,168,152,98.0,2.88,4,0,university_of_maryland_college_park,reject,10
318,162,156,113.0,3.03,16,0,university_of_maryland_college_park,reject,10
315,163,152,102.0,3.6,31,0,university_of_maryland_college_park,reject,10
320,160,160,108.0,3.02,8,3,university_of_maryland_college_park,reject,10
322,170,152,110.0,3.65,22,0,university_of_maryland_college_park,reject,10
316,166,150,103.0,3.3,7,0,university_of_maryland_college_park,reject,10
323,163,160,112.0,3.5,2,0,university_of_maryland_college_park,reject,10
328,165,163,108.0,2.84,31,3,university_of_maryland_college_park,reject,10
317,163,154,112.0,3.71,9,2,university_of_maryland_college_park,reject,10
323,170,153,108.0,3.37,14,0,university_of_maryland_college_park,reject,10
310,163,147,75.0,2.92,5,3,university_of_maryland_college_park,reject,10
329,170,159,111.0,3.88,20,3,university_of_maryland_college_park,reject,10
316,165,151,104.0,3.68,20,3,university_of_maryland_college_park,reject,10
321,166,155,93.0,3.48,2,0,university_of_maryland_college_park,reject,10
316,167,149,107.0,3.6,27,0,university_of_maryland_college_park,reject,10
320,163,157,114.0,3.08,10,0,university_of_maryland_college_park,reject,10
315,158,157,113.0,2.38,17,2,university_of_maryland_college_park,reject,10
321,164,157,104.0,3.52,10,3,university_of_maryland_college_park,reject,10
314,160,154,107.0,2.99,24,0,university_of_maryland_college_park,reject,10
319,170,149,105.0,3.36,22,3,university_of_maryland_college_park,reject,10
329,170,159,105.0,3.18,30,0,university_of_maryland_college_park,reject,10
331,170,161,113.0,3.28,34,1,university_of_maryland_college_park,reject,10
321,166,155,102.0,3.28,0,3,university_of_maryland_college_park,reject,10
322,167,155,105.0,3.4,36,0,university_of_maryland_college_park,reject,10
320,167,153,101.0,2.93,48,0,university_of_maryland_college_park,reject,10
324,168,156,113.0,3.15,12,0,university_of_maryland_college_park,reject,10
311,163,148,105.0,1.25,0,0,university_of_maryland_college_park,reject,10
316,165,151,117.0,3.65,2,3,university_of_maryland_college_park,reject,10
337,168,169,115.0,3.5,18,3,university_of_maryland_college_park,reject,10
326,166,160,117.0,3.64,10,3,university_of_maryland_college_park,reject,10
326,166,160,117.0,3.64,10,3,university_of_maryland_college_park,reject,10
325,164,161,111.0,3.48,7,0,university_of_maryland_college_park,reject,10
333,170,163,110.0,3.46,36,0,university_of_maryland_college_park,reject,10
334,166,168,120.0,3.54,1,3,university_of_maryland_college_park,reject,10
326,167,159,116.0,3.28,12,0,university_of_maryland_college_park,reject,10
315,165,150,105.0,2.59,9,3,university_of_maryland_college_park,reject,10
328,169,159,115.0,3.66,12,3,university_of_maryland_college_park,reject,10
325,170,155,103.0,2.84,30,0,university_of_maryland_college_park,reject,10
330,170,160,85.0,3.64,4,3,university_of_maryland_college_park,reject,10
321,169,152,103.0,2.54,40,0,university_of_maryland_college_park,reject,10
323,168,155,116.0,3.44,20,0,university_of_maryland_college_park,reject,10
319,168,151,109.0,3.34,12,0,university_of_maryland_college_park,reject,10
320,164,156,102.0,3.03,44,0,university_of_maryland_college_park,reject,10
316,162,154,110.0,3.64,21,0,university_of_maryland_college_park,reject,10
319,168,151,92.0,3.2,12,0,university_of_maryland_college_park,reject,10
327,169,158,102.0,2.6,14,1,university_of_maryland_college_park,reject,10
327,169,158,102.0,2.6,14,1,university_of_maryland_college_park,reject,10
322,167,155,105.0,3.22,19,0,university_of_maryland_college_park,reject,10
319,166,153,111.0,3.69,14,0,university_of_maryland_college_park,reject,10
311,159,152,104.0,3.1,21,3,university_of_maryland_college_park,reject,10
324,166,158,116.0,3.68,35,0,university_of_maryland_college_park,reject,10
330,168,162,117.0,3.5,18,0,university_of_maryland_college_park,reject,10
304,159,145,99.0,3.04,6,0,university_of_maryland_college_park,reject,10
313,165,148,102.0,2.86,41,0,university_of_maryland_college_park,reject,10
321,167,154,113.0,3.44,0,0,university_of_maryland_college_park,reject,10
303,154,149,91.0,1.25,33,0,university_of_maryland_college_park,reject,10
304,160,144,101,3.26,6,0,university_of_maryland_college_park,reject,10
311,163,148,75.0,3.24,3,0,university_of_maryland_college_park,reject,10
320,169,151,105.0,3.28,0,3,university_of_maryland_college_park,reject,10
317,166,151,96.0,3.64,6,0,university_of_maryland_college_park,reject,10
319,168,151,106.0,3.4,16,0,university_of_maryland_college_park,reject,10
322,166,156,106.0,3.0,21,0,university_of_maryland_college_park,reject,10
327,170,157,75.0,3.13,4,0,university_of_maryland_college_park,reject,10
314,163,151,101,3.27,27,0,university_of_maryland_college_park,reject,10
326,167,159,112.0,3.35,21,0,university_of_maryland_college_park,reject,10
319,165,154,101.0,3.65,32,0,university_of_maryland_college_park,reject,10
314,162,152,106.0,2.66,23,2,university_of_maryland_college_park,reject,10
325,168,157,105.0,2.95,28,0,university_of_maryland_college_park,reject,10
320,165,155,96.0,2.44,15,0,university_of_maryland_college_park,reject,10
317,164,153,106.0,3.0,53,3,university_of_maryland_college_park,reject,10
312,155,157,114.0,2.81,27,0,university_of_maryland_college_park,reject,10
312,160,152,102.0,3.14,1,3,university_of_maryland_college_park,reject,10
322,170,152,107.0,3.08,8,0,university_of_maryland_college_park,reject,10
334,167,167,119.0,3.5,50,0,university_of_maryland_college_park,reject,10
322,155,167,109.0,3.0,20,3,university_of_maryland_college_park,reject,10
314,161,153,102.0,3.46,16,0,university_of_maryland_college_park,reject,10
327,170,157,112.0,3.16,26,0,university_of_maryland_college_park,reject,10
312,161,151,102.0,3.89,44,3,university_of_maryland_college_park,reject,10
312,161,151,102.0,3.89,44,3,university_of_maryland_college_park,reject,10
305,153,152,101,3.38,5,3,university_of_maryland_college_park,reject,10
322,163,159,107.0,2.87,5,3,university_of_maryland_college_park,reject,10
329,170,159,110.0,3.52,60,0,university_of_maryland_college_park,reject,10
327,168,159,106.0,3.26,17,3,university_of_maryland_college_park,reject,10
313,165,148,102.0,2.64,30,3,university_of_maryland_college_park,reject,10
317,166,151,100.0,3.49,32,0,university_of_maryland_college_park,reject,10
315,159,156,102.0,3.37,27,0,university_of_maryland_college_park,reject,10
321,169,152,112.0,3.64,18,3,university_of_maryland_college_park,reject,10
323,166,157,111.0,3.9,23,0,university_of_maryland_college_park,reject,10
324,169,155,112.0,2.88,8,0,university_of_maryland_college_park,reject,10
327,167,160,113.0,3.7,0,0,university_of_maryland_college_park,reject,10
332,170,162,117.0,3.78,0,0,university_of_maryland_college_park,reject,10
321,161,160,118.0,3.12,1,2,university_of_maryland_college_park,reject,10
318,166,152,117.0,3.66,0,0,university_of_maryland_college_park,reject,10
323,162,161,109.0,3.49,19,0,university_of_maryland_college_park,reject,10
323,162,161,109.0,3.49,19,0,university_of_maryland_college_park,reject,10
328,167,161,111.0,3.16,32,3,university_of_maryland_college_park,reject,10
325,170,155,105.0,3.8,19,0,university_of_maryland_college_park,reject,10
315,166,149,110.0,3.39,22,0,university_of_maryland_college_park,reject,10
327,170,157,106.0,3.12,19,3,university_of_maryland_college_park,reject,10
326,169,157,109.0,3.78,20,3,university_of_maryland_college_park,reject,10
328,164,164,116.0,3.64,0,0,university_of_maryland_college_park,reject,10
324,164,160,109.0,3.2,15,0,university_of_maryland_college_park,reject,10
320,167,153,107.0,3.5,0,3,university_of_maryland_college_park,reject,10
331,168,163,115.0,3.36,2,0,university_of_maryland_college_park,reject,10
314,164,150,103.0,3.64,1,3,university_of_maryland_college_park,reject,10
314,165,149,108.0,2.99,5,3,university_of_maryland_college_park,reject,10
309,163,146,96.0,3.48,12,0,university_of_maryland_college_park,reject,10
324,168,156,103.0,2.98,60,0,university_of_maryland_college_park,reject,10
326,169,157,111.0,3.35,6,0,university_of_maryland_college_park,reject,10
319,163,156,113.0,3.24,0,0,university_of_maryland_college_park,reject,10
329,168,161,108.0,3.31,18,2,university_of_maryland_college_park,reject,10
329,168,161,108.0,3.31,18,2,university_of_maryland_college_park,reject,10
332,170,162,114.0,3.4,24,0,university_of_maryland_college_park,reject,10
313,167,146,101.0,3.62,36,0,university_of_maryland_college_park,reject,10
329,169,160,114.0,3.62,1,0,university_of_maryland_college_park,reject,10
326,163,163,114.0,3.74,6,3,university_of_maryland_college_park,reject,10
320,170,150,104.0,3.86,2,1,university_of_maryland_college_park,reject,10
328,168,160,114.0,3.54,1,0,university_of_maryland_college_park,reject,10
325,170,155,99.0,3.0,0,0,university_of_maryland_college_park,reject,10
323,168,155,108.0,2.64,6,3,university_of_maryland_college_park,reject,10
325,166,159,104.0,2.69,34,0,university_of_maryland_college_park,reject,10
320,165,155,105.0,3.27,31,1,university_of_maryland_college_park,reject,10
315,168,147,75.0,3.58,6,3,university_of_maryland_college_park,reject,10
324,169,155,105.0,3.65,6,3,university_of_maryland_college_park,reject,10
315,163,152,108.0,3.4,14,0,university_of_maryland_college_park,reject,10
312,160,152,101,3.0,33,2,university_of_maryland_college_park,reject,10
328,170,158,110.0,3.39,6,0,university_of_maryland_college_park,reject,10
327,164,163,111.0,3.46,22,0,university_of_maryland_college_park,reject,10
322,167,155,103.0,2.92,23,0,university_of_maryland_college_park,reject,10
323,169,154,109.0,3.83,4,2,university_of_maryland_college_park,reject,10
314,161,153,100.0,3.16,0,0,university_of_maryland_college_park,reject,10
309,159,150,97.0,2.75,31,0,university_of_maryland_college_park,reject,10
329,167,162,107.0,3.39,48,3,university_of_maryland_college_park,reject,10
318,168,150,106.0,3.4,0,0,university_of_maryland_college_park,reject,10
328,169,159,113.0,3.04,3,0,university_of_maryland_college_park,reject,10
327,166,161,108.0,3.18,10,3,university_of_maryland_college_park,reject,10
307,161,146,88.0,3.26,12,0,university_of_maryland_college_park,reject,10
309,160,149,99.0,2.6,0,0,university_of_maryland_college_park,reject,10
300,155,145,65.0,2.53,0,0,university_of_maryland_college_park,reject,10
308,158,150,101.0,3.49,0,3,university_of_maryland_college_park,reject,10
315,168,147,96.0,3.52,68,0,university_of_maryland_college_park,reject,10
320,163,157,108.0,3.56,3,0,university_of_maryland_college_park,reject,10
320,170,150,100.0,3.39,17,0,university_of_maryland_college_park,reject,10
312,160,152,0,2.92,14,0,university_of_maryland_college_park,reject,10
312,161,151,115.0,2.5,1,0,university_of_maryland_college_park,reject,10
325,167,158,112.0,3.28,41,0,university_of_maryland_college_park,reject,10
308,157,151,96.0,3.01,15,0,university_of_maryland_college_park,reject,10
327,166,161,115.0,3.79,36,0,university_of_maryland_college_park,reject,10
335,168,167,0,3.89,3,3,university_of_maryland_college_park,reject,10
320,170,150,105.0,3.5,26,0,university_of_maryland_college_park,reject,10
324,170,154,112.0,3.32,4,3,university_of_maryland_college_park,reject,10
318,161,157,116.0,2.88,18,0,university_of_maryland_college_park,reject,10
321,168,153,0,2.77,18,0,university_of_maryland_college_park,reject,10
326,169,157,0,3.01,32,0,university_of_maryland_college_park,reject,10
323,166,157,114.0,3.64,20,3,university_of_maryland_college_park,reject,10
323,166,157,114.0,3.64,20,3,university_of_maryland_college_park,reject,10
324,167,157,111.0,2.66,40,0,university_of_maryland_college_park,reject,10
319,167,152,109.0,3.28,7,0,university_of_maryland_college_park,reject,10
324,167,157,112.0,2.65,6,3,university_of_maryland_college_park,reject,10
316,163,153,104.0,3.68,18,0,university_of_maryland_college_park,reject,10
337,170,167,115.0,2.7,26,0,university_of_maryland_college_park,reject,10
310,161,149,75.0,2.65,38,3,university_of_maryland_college_park,reject,10
317,164,153,110.0,3.09,3,0,university_of_maryland_college_park,reject,10
326,170,156,101.0,3.48,19,3,university_of_maryland_college_park,reject,10
310,158,152,102.0,2.96,34,0,university_of_maryland_college_park,reject,10
317,162,155,0,3.2,34,0,university_of_maryland_college_park,reject,10
319,164,155,114,2.37,0,0,university_of_maryland_college_park,reject,10
321,169,152,98.0,3.24,0,0,university_of_maryland_college_park,reject,10
327,168,159,107.0,3.52,2,0,university_of_maryland_college_park,reject,10
321,169,152,102.0,2.97,18,0,university_of_maryland_college_park,reject,10
317,167,150,75.0,2.06,21,0,university_of_maryland_college_park,reject,10
317,167,150,75.0,2.06,21,0,university_of_maryland_college_park,reject,10
315,164,151,0,3.12,0,2,university_of_maryland_college_park,reject,10
327,169,158,109.0,3.46,40,0,university_of_maryland_college_park,reject,10
315,165,150,102.0,3.1,8,0,university_of_maryland_college_park,reject,10
322,166,156,0,3.21,5,3,university_of_maryland_college_park,reject,10
313,163,150,116.0,2.99,2,0,university_of_maryland_college_park,reject,10
319,167,152,114.0,3.47,2,0,university_of_maryland_college_park,reject,10
319,165,154,110.0,3.49,24,3,university_of_maryland_college_park,reject,10
334,170,164,0,3.28,8,3,university_of_maryland_college_park,reject,10
315,168,147,106.0,3.6,2,0,university_of_maryland_college_park,reject,10
315,164,151,114.0,2.95,30,0,university_of_maryland_college_park,reject,10
319,162,157,104.0,3.3,18,0,university_of_maryland_college_park,reject,10
314,168,146,101.0,3.21,34,0,university_of_maryland_college_park,reject,10
326,168,158,0,3.22,1,3,university_of_maryland_college_park,reject,10
320,161,159,110.0,3.12,32,0,university_of_maryland_college_park,reject,10
323,167,156,110.0,3.0,29,0,university_of_maryland_college_park,reject,10
320,170,150,104.0,3.42,9,0,university_of_maryland_college_park,reject,10
320,170,150,104.0,3.42,9,0,university_of_maryland_college_park,reject,10
319,167,152,98.0,3.59,9,0,university_of_maryland_college_park,reject,10
320,164,156,118.0,3.77,2,0,university_of_maryland_college_park,reject,10
326,163,163,110.0,3.34,24,0,university_of_maryland_college_park,reject,10
322,164,158,115.0,3.44,18,0,university_of_maryland_college_park,reject,10
325,163,162,116.0,3.34,34,0,university_of_maryland_college_park,reject,10
328,168,160,110.0,3.62,1,0,university_of_maryland_college_park,reject,10
326,168,158,105.0,3.32,2,0,university_of_maryland_college_park,reject,10
324,166,158,112.0,2.18,20,0,university_of_maryland_college_park,reject,10
325,170,155,107.0,3.66,8,3,university_of_maryland_college_park,reject,10
321,165,156,105.0,3.0,39,0,university_of_maryland_college_park,reject,10
316,163,153,104.0,3.24,48,0,university_of_maryland_college_park,reject,10
325,166,159,0,3.22,20,0,university_of_maryland_college_park,reject,10
321,164,157,118.0,3.57,16,3,university_of_maryland_college_park,reject,10
325,170,155,114.0,3.24,0,0,university_of_maryland_college_park,reject,10
319,167,152,107.0,3.44,0,0,university_of_maryland_college_park,reject,10
315,167,148,0,2.94,0,3,university_of_maryland_college_park,reject,10
319,170,149,0,3.32,0,3,university_of_maryland_college_park,reject,10
309,168,141,103.0,3.48,2,0,michigan_technological_university,accept,117
309,168,141,103.0,3.48,2,0,michigan_technological_university,accept,117
300,158,142,84.0,2.6,10,2,michigan_technological_university,accept,117
303,160,143,101,3.37,0,0,michigan_technological_university,accept,117
317,162,155,87.0,2.68,0,0,michigan_technological_university,accept,117
301,155,146,75.0,2.42,1,0,michigan_technological_university,accept,117
305,166,139,101,3.37,4,0,michigan_technological_university,accept,117
305,159,146,65.0,2.6,47,3,michigan_technological_university,accept,117
291,160,131,65.0,3.22,6,0,michigan_technological_university,accept,117
296,158,138,84.0,3.62,4,3,michigan_technological_university,accept,117
310,160,150,99.0,3.83,32,3,michigan_technological_university,accept,117
303,156,147,101,3.28,27,0,michigan_technological_university,accept,117
310,158,152,75.0,3.4,0,0,michigan_technological_university,accept,117
302,160,142,90.0,3.08,15,0,michigan_technological_university,accept,117
310,161,149,75.0,3.45,20,3,michigan_technological_university,accept,117
302,160,142,65.0,2.95,0,2,michigan_technological_university,accept,117
305,161,144,101,3.03,34,0,michigan_technological_university,accept,117
313,161,152,106.0,3.28,41,1,michigan_technological_university,accept,117
303,156,147,101,2.92,23,3,michigan_technological_university,accept,117
305,162,143,65.0,2.94,13,0,michigan_technological_university,accept,117
315,165,150,102.0,2.08,37,0,michigan_technological_university,accept,117
315,165,150,102.0,2.08,37,0,michigan_technological_university,accept,117
310,165,145,90.0,2.51,57,0,michigan_technological_university,accept,117
299,162,137,65.0,2.75,26,0,michigan_technological_university,accept,117
303,160,143,89.0,3.0,0,0,michigan_technological_university,accept,117
311,163,148,65.0,2.58,0,0,michigan_technological_university,accept,117
304,164,140,75.0,3.1,26,0,michigan_technological_university,accept,117
312,159,153,107.0,3.34,0,0,michigan_technological_university,accept,117
304,150,154,0,2.16,39,0,michigan_technological_university,accept,117
330,166,164,115.0,3.25,0,0,michigan_technological_university,accept,117
288,150,138,101,2.75,0,0,michigan_technological_university,accept,117
310,161,149,99.0,2.55,38,0,michigan_technological_university,accept,117
308,165,143,0,3.22,0,0,michigan_technological_university,accept,117
328,169,159,0,2.94,0,0,michigan_technological_university,accept,117
299,149,150,91.0,2.7,33,0,michigan_technological_university,accept,117
321,170,151,75.0,3.32,0,0,michigan_technological_university,accept,117
302,156,146,65.0,1.42,2,0,michigan_technological_university,accept,117
304,163,141,0,2.17,6,0,michigan_technological_university,accept,117
304,158,146,75.0,3.0,0,0,michigan_technological_university,accept,117
302,154,148,100.0,1.9,0,0,michigan_technological_university,accept,117
312,166,146,99.0,2.6,27,0,michigan_technological_university,accept,117
308,158,150,106.0,2.57,0,0,michigan_technological_university,accept,117
308,158,150,106.0,2.57,0,0,michigan_technological_university,accept,117
313,160,153,108.0,3.02,20,3,michigan_technological_university,accept,117
306,162,144,101,3.13,0,2,michigan_technological_university,accept,117
308,157,151,94.0,2.49,0,0,michigan_technological_university,accept,117
318,163,155,110.0,2.82,6,0,michigan_technological_university,accept,117
309,159,150,114,2.3,20,0,michigan_technological_university,accept,117
312,166,146,104.0,2.56,0,0,michigan_technological_university,accept,117
306,157,149,93.0,3.51,46,0,michigan_technological_university,accept,117
307,162,145,105.0,2.13,4,3,michigan_technological_university,accept,117
308,162,146,101.0,3.0,13,0,michigan_technological_university,accept,117
313,163,150,0,3.08,0,0,michigan_technological_university,accept,117
305,155,150,87.0,2.96,1,0,michigan_technological_university,accept,117
300,152,148,90.0,2.0,24,0,michigan_technological_university,accept,117
311,161,150,109.0,1.48,3,0,michigan_technological_university,accept,117
297,160,137,65.0,3.6,15,3,michigan_technological_university,accept,117
305,161,144,103.0,2.54,12,0,michigan_technological_university,accept,117
318,161,157,103.0,3.16,7,0,michigan_technological_university,accept,117
302,160,142,82.0,2.7,1,0,michigan_technological_university,accept,117
301,153,148,82.0,2.8,26,0,michigan_technological_university,accept,117
323,164,159,111.0,2.8,16,0,michigan_technological_university,accept,117
305,160,145,105.0,3.56,0,0,michigan_technological_university,accept,117
305,160,145,105.0,3.56,0,0,michigan_technological_university,accept,117
297,153,144,99.0,2.2,60,0,michigan_technological_university,accept,117
301,156,145,95.0,2.35,24,2,michigan_technological_university,accept,117
311,162,149,101,3.05,19,0,michigan_technological_university,accept,117
310,161,149,101,3.6,0,0,michigan_technological_university,accept,117
301,155,146,89.0,2.86,3,0,michigan_technological_university,accept,117
315,158,157,104.0,2.06,18,1,michigan_technological_university,accept,117
308,167,141,65.0,3.47,31,0,michigan_technological_university,accept,117
315,170,145,108.0,2.9,2,0,michigan_technological_university,accept,117
313,170,143,84.0,3.42,0,0,michigan_technological_university,accept,117
310,159,151,107.0,3.55,44,0,michigan_technological_university,accept,117
320,166,154,109.0,3.14,40,0,michigan_technological_university,accept,117
325,170,155,97.0,3.14,0,0,michigan_technological_university,accept,117
323,170,153,105.0,3.28,0,0,michigan_technological_university,accept,117
310,158,152,101.0,3.33,77,0,michigan_technological_university,accept,117
303,160,143,65.0,3.25,0,0,michigan_technological_university,accept,117
323,168,155,104.0,2.5,15,0,michigan_technological_university,accept,117
308,162,146,75.0,3.02,13,0,michigan_technological_university,accept,117
306,159,147,88.0,3.12,20,0,michigan_technological_university,accept,117
306,159,147,88.0,3.12,20,0,michigan_technological_university,accept,117
317,165,152,107.0,2.75,0,0,michigan_technological_university,accept,117
312,161,151,99.0,2.8,30,0,michigan_technological_university,accept,117
302,156,146,94.0,3.4,17,0,michigan_technological_university,accept,117
312,164,148,111.0,3.33,24,0,michigan_technological_university,accept,117
312,163,149,103.0,2.94,0,0,michigan_technological_university,accept,117
302,161,141,96.0,3.05,30,3,michigan_technological_university,accept,117
300,159,141,110.0,3.55,1,0,michigan_technological_university,accept,117
310,164,146,98.0,2.86,0,0,michigan_technological_university,accept,117
309,159,150,105.0,2.35,0,0,michigan_technological_university,accept,117
321,161,160,103.0,2.5,30,1,michigan_technological_university,accept,117
309,159,150,105.0,2.8,0,0,michigan_technological_university,accept,117
311,161,150,95.0,2.22,0,0,michigan_technological_university,accept,117
320,165,155,106.0,3.36,30,3,michigan_technological_university,accept,117
307,161,146,98.0,2.5,0,0,michigan_technological_university,accept,117
309,160,149,106.0,2.7,20,0,michigan_technological_university,accept,117
301,154,147,101,2.8,30,0,michigan_technological_university,accept,117
312,163,149,103.0,3.55,30,0,michigan_technological_university,accept,117
311,161,150,109.0,2.22,10,3,michigan_technological_university,accept,117
305,145,160,101.0,1.95,50,2,michigan_technological_university,reject,117
305,145,160,101.0,1.95,50,2,michigan_technological_university,reject,117
300,161,139,75.0,2.68,12,0,michigan_technological_university,reject,117
309,166,143,84.0,2.4,0,0,michigan_technological_university,reject,117
300,153,147,86.0,1.32,0,0,michigan_technological_university,reject,117
310,166,144,114,2.42,0,0,michigan_technological_university,reject,117
301,153,148,95.0,1.82,12,3,michigan_technological_university,reject,117
305,162,143,96.0,2.86,27,0,michigan_technological_university,reject,117
308,157,151,93.0,1.28,0,0,michigan_technological_university,reject,117
293,156,137,89.0,1.8,2,1,michigan_technological_university,reject,117
319,170,149,0,3.32,0,3,michigan_technological_university,reject,117
305,157,148,105.0,1.72,35,0,michigan_technological_university,reject,117
303,156,147,112.0,2.08,0,0,michigan_technological_university,reject,117
304,156,148,104.0,2.7,25,0,michigan_technological_university,reject,117
313,162,151,102.0,2.9,33,0,michigan_technological_university,reject,117
293,158,135,75.0,3.4,6,0,michigan_technological_university,reject,117
310,158,152,107.0,2.48,13,0,michigan_technological_university,reject,117
310,158,152,107.0,2.48,13,0,michigan_technological_university,reject,117
303,159,144,93.0,2.76,0,0,michigan_technological_university,reject,117
313,167,146,99.0,3.0,28,0,michigan_technological_university,reject,117
310,158,152,95.0,1.95,9,3,michigan_technological_university,reject,117
298,158,140,78,2.5,9,3,michigan_technological_university,reject,117
301,158,143,86.0,1.9,30,0,michigan_technological_university,reject,117
320,170,150,103.0,3.06,32,0,michigan_technological_university,reject,117
303,160,143,65.0,3.66,0,0,michigan_technological_university,reject,117
304,156,148,105.0,2.27,132,0,michigan_technological_university,reject,117
308,168,140,78,2.97,30,0,michigan_technological_university,reject,117
312,167,145,94.0,2.25,0,0,michigan_technological_university,reject,117
319,165,154,106.0,2.85,20,0,michigan_technological_university,reject,117
296,161,135,65.0,3.2,0,0,michigan_technological_university,reject,117
289,144,145,85.0,3.32,0,0,michigan_technological_university,reject,117
306,165,141,88.0,3.32,10,0,michigan_technological_university,reject,117
306,161,145,65.0,3.25,30,0,michigan_technological_university,reject,117
300,158,142,97.0,1.96,0,0,michigan_technological_university,reject,117
302,156,146,75.0,1.7,0,0,michigan_technological_university,reject,117
309,160,149,97.0,2.05,0,0,michigan_technological_university,reject,117
307,161,146,101,3.15,30,0,michigan_technological_university,reject,117
317,167,150,104.0,3.28,2,0,north_carolina_state_university_raleigh,accept,49
317,167,150,104.0,3.28,2,0,north_carolina_state_university_raleigh,accept,49
320,167,153,107.0,2.8,23,0,north_carolina_state_university_raleigh,accept,49
319,168,151,92.0,3.2,12,0,north_carolina_state_university_raleigh,accept,49
324,167,157,108.0,3.12,6,2,north_carolina_state_university_raleigh,accept,49
326,170,156,109.0,3.27,0,0,north_carolina_state_university_raleigh,accept,49
317,165,152,0,3.1,0,0,north_carolina_state_university_raleigh,accept,49
317,167,150,110.0,3.76,13,0,north_carolina_state_university_raleigh,accept,49
320,166,154,107.0,3.8,12,0,north_carolina_state_university_raleigh,accept,49
318,167,151,113.0,3.14,3,0,north_carolina_state_university_raleigh,accept,49
325,170,155,107.0,2.85,9,0,north_carolina_state_university_raleigh,accept,49
316,165,151,107.0,3.69,2,1,north_carolina_state_university_raleigh,accept,49
320,164,156,108.0,3.4,18,0,north_carolina_state_university_raleigh,accept,49
324,166,158,109.0,3.68,13,0,north_carolina_state_university_raleigh,accept,49
315,164,151,109.0,3.05,37,0,north_carolina_state_university_raleigh,accept,49
322,161,161,114.0,3.34,1,0,north_carolina_state_university_raleigh,accept,49
321,168,153,114.0,3.73,22,3,north_carolina_state_university_raleigh,accept,49
316,167,149,101,3.32,29,0,north_carolina_state_university_raleigh,accept,49
324,167,157,117.0,3.32,57,0,north_carolina_state_university_raleigh,accept,49
320,164,156,105.0,3.05,28,0,north_carolina_state_university_raleigh,accept,49
317,167,150,104.0,3.28,2,0,north_carolina_state_university_raleigh,accept,49
317,167,150,104.0,3.28,2,0,north_carolina_state_university_raleigh,accept,49
320,167,153,107.0,2.8,23,0,north_carolina_state_university_raleigh,accept,49
319,168,151,92.0,3.2,12,0,north_carolina_state_university_raleigh,accept,49
324,167,157,108.0,3.12,6,2,north_carolina_state_university_raleigh,accept,49
326,170,156,109.0,3.27,0,0,north_carolina_state_university_raleigh,accept,49
317,165,152,0,3.1,0,0,north_carolina_state_university_raleigh,accept,49
317,167,150,110.0,3.76,13,0,north_carolina_state_university_raleigh,accept,49
320,166,154,107.0,3.8,12,0,north_carolina_state_university_raleigh,accept,49
318,167,151,113.0,3.14,3,0,north_carolina_state_university_raleigh,accept,49
325,170,155,107.0,2.85,9,0,north_carolina_state_university_raleigh,accept,49
316,165,151,107.0,3.69,2,1,north_carolina_state_university_raleigh,accept,49
320,164,156,108.0,3.4,18,0,north_carolina_state_university_raleigh,accept,49
324,166,158,109.0,3.68,13,0,north_carolina_state_university_raleigh,accept,49
315,164,151,109.0,3.05,37,0,north_carolina_state_university_raleigh,accept,49
322,161,161,114.0,3.34,1,0,north_carolina_state_university_raleigh,accept,49
321,168,153,114.0,3.73,22,3,north_carolina_state_university_raleigh,accept,49
316,167,149,101,3.32,29,0,north_carolina_state_university_raleigh,accept,49
324,167,157,117.0,3.32,57,0,north_carolina_state_university_raleigh,accept,49
320,164,156,105.0,3.05,28,0,north_carolina_state_university_raleigh,accept,49
323,170,153,108.0,3.37,14,0,north_carolina_state_university_raleigh,accept,49
323,170,153,108.0,3.37,14,0,north_carolina_state_university_raleigh,accept,49
320,168,152,107.0,3.52,41,3,north_carolina_state_university_raleigh,accept,49
321,168,153,103.0,3.46,38,0,north_carolina_state_university_raleigh,accept,49
314,164,150,109.0,3.4,0,1,north_carolina_state_university_raleigh,accept,49
318,167,151,104.0,3.1,0,0,north_carolina_state_university_raleigh,accept,49
323,167,156,101,2.65,15,0,north_carolina_state_university_raleigh,accept,49
318,170,148,101.0,4.0,12,0,north_carolina_state_university_raleigh,accept,49
332,170,162,106.0,3.38,20,3,north_carolina_state_university_raleigh,accept,49
321,170,151,100.0,2.6,7,3,north_carolina_state_university_raleigh,accept,49
316,166,150,108.0,3.88,30,0,north_carolina_state_university_raleigh,accept,49
329,168,161,109.0,3.48,2,3,north_carolina_state_university_raleigh,accept,49
318,166,152,108.0,3.76,28,2,north_carolina_state_university_raleigh,accept,49
322,164,158,107.0,3.51,0,0,north_carolina_state_university_raleigh,accept,49
322,170,152,105.0,3.17,25,2,north_carolina_state_university_raleigh,accept,49
316,162,154,110.0,3.64,21,0,north_carolina_state_university_raleigh,accept,49
321,165,156,0,3.73,0,0,north_carolina_state_university_raleigh,accept,49
312,167,145,103.0,3.4,60,0,north_carolina_state_university_raleigh,accept,49
317,165,152,100.0,3.27,0,0,north_carolina_state_university_raleigh,accept,49
316,167,149,103.0,3.45,19,0,north_carolina_state_university_raleigh,accept,49
327,168,159,0,3.74,0,0,north_carolina_state_university_raleigh,accept,49
329,170,159,118.0,3.38,15,0,north_carolina_state_university_raleigh,accept,49
320,168,152,0,3.8,14,3,north_carolina_state_university_raleigh,accept,49
325,169,156,112.0,3.2,36,3,north_carolina_state_university_raleigh,accept,49
314,167,147,97.0,3.2,0,0,north_carolina_state_university_raleigh,accept,49
321,168,153,114.0,3.77,15,0,north_carolina_state_university_raleigh,accept,49
328,168,160,117.0,3.7,5,3,north_carolina_state_university_raleigh,accept,49
324,167,157,103.0,3.32,46,0,north_carolina_state_university_raleigh,accept,49
328,168,160,112.0,3.54,19,0,north_carolina_state_university_raleigh,accept,49
322,167,155,105.0,3.22,19,0,north_carolina_state_university_raleigh,accept,49
320,169,151,114,3.58,6,0,north_carolina_state_university_raleigh,accept,49
318,162,156,108.0,3.8,20,3,north_carolina_state_university_raleigh,accept,49
317,169,148,96.0,2.79,9,3,north_carolina_state_university_raleigh,accept,49
320,168,152,99.0,3.48,37,0,north_carolina_state_university_raleigh,accept,49
325,167,158,115.0,3.74,20,0,north_carolina_state_university_raleigh,accept,49
318,168,150,110.0,3.5,17,3,north_carolina_state_university_raleigh,accept,49
318,168,150,110.0,3.5,17,3,north_carolina_state_university_raleigh,accept,49
316,165,151,104.0,3.68,20,3,north_carolina_state_university_raleigh,accept,49
324,170,154,110.0,3.6,0,3,north_carolina_state_university_raleigh,accept,49
329,168,161,115.0,3.32,0,3,north_carolina_state_university_raleigh,accept,49
320,170,150,75.0,3.4,2,0,north_carolina_state_university_raleigh,accept,49
324,169,155,113.0,3.25,5,0,north_carolina_state_university_raleigh,accept,49
322,168,154,108.0,3.56,20,0,north_carolina_state_university_raleigh,accept,49
321,168,153,97.0,3.12,3,0,north_carolina_state_university_raleigh,accept,49
333,168,165,115.0,3.16,2,0,north_carolina_state_university_raleigh,accept,49
320,165,155,105.0,3.27,31,1,north_carolina_state_university_raleigh,accept,49
324,169,155,109.0,3.33,21,3,north_carolina_state_university_raleigh,accept,49
314,165,149,98.0,3.08,53,2,north_carolina_state_university_raleigh,accept,49
320,153,167,107.0,3.52,0,0,north_carolina_state_university_raleigh,accept,49
320,170,150,107.0,3.68,4,0,north_carolina_state_university_raleigh,accept,49
327,169,158,107.0,3.3,5,0,north_carolina_state_university_raleigh,accept,49
326,165,161,114.0,3.36,15,0,north_carolina_state_university_raleigh,accept,49
318,169,149,109.0,3.48,0,0,north_carolina_state_university_raleigh,accept,49
324,168,156,113.0,3.15,12,0,north_carolina_state_university_raleigh,accept,49
319,165,154,110.0,3.84,26,0,north_carolina_state_university_raleigh,accept,49
319,165,154,110.0,3.84,26,0,north_carolina_state_university_raleigh,accept,49
317,165,152,107.0,3.72,0,2,north_carolina_state_university_raleigh,accept,49
314,169,145,99.0,3.26,12,0,north_carolina_state_university_raleigh,accept,49
318,163,155,108.0,2.77,15,3,north_carolina_state_university_raleigh,accept,49
317,169,148,109.0,3.68,2,0,north_carolina_state_university_raleigh,accept,49
320,169,151,105.0,3.28,0,3,north_carolina_state_university_raleigh,accept,49
321,168,153,104.0,3.66,8,0,north_carolina_state_university_raleigh,accept,49
323,165,158,111.0,2.67,0,0,north_carolina_state_university_raleigh,accept,49
316,166,150,100.0,3.47,9,3,north_carolina_state_university_raleigh,accept,49
315,165,150,98.0,3.76,6,3,north_carolina_state_university_raleigh,accept,49
326,169,157,111.0,3.4,0,0,north_carolina_state_university_raleigh,accept,49
317,169,148,75.0,3.68,2,0,north_carolina_state_university_raleigh,accept,49
330,169,161,105.0,3.75,3,3,north_carolina_state_university_raleigh,accept,49
321,170,151,106.0,3.62,4,3,north_carolina_state_university_raleigh,accept,49
320,168,152,98.0,2.88,4,0,north_carolina_state_university_raleigh,accept,49
324,169,155,110.0,2.51,13,3,north_carolina_state_university_raleigh,accept,49
318,168,150,0,3.39,2,0,north_carolina_state_university_raleigh,accept,49
323,168,155,107.0,2.76,0,0,north_carolina_state_university_raleigh,accept,49
316,165,151,110.0,3.56,18,0,north_carolina_state_university_raleigh,accept,49
319,169,150,105.0,3.3,0,0,north_carolina_state_university_raleigh,accept,49
319,169,150,105.0,3.3,0,0,north_carolina_state_university_raleigh,accept,49
319,169,150,105.0,3.3,0,0,north_carolina_state_university_raleigh,accept,49
315,167,148,103.0,3.62,21,0,north_carolina_state_university_raleigh,accept,49
319,168,151,95.0,3.67,20,0,north_carolina_state_university_raleigh,accept,49
320,168,152,99.0,3.3,25,3,north_carolina_state_university_raleigh,accept,49
317,162,155,98.0,3.78,29,0,north_carolina_state_university_raleigh,accept,49
319,164,155,108.0,3.28,30,0,north_carolina_state_university_raleigh,accept,49
330,160,170,118.0,3.7,10,3,north_carolina_state_university_raleigh,accept,49
322,170,152,109.0,3.35,17,3,north_carolina_state_university_raleigh,accept,49
320,167,153,103.0,3.23,5,3,north_carolina_state_university_raleigh,accept,49
322,170,152,104.0,3.25,2,3,north_carolina_state_university_raleigh,accept,49
325,166,159,114,3.64,24,0,north_carolina_state_university_raleigh,accept,49
325,166,159,114,3.64,24,0,north_carolina_state_university_raleigh,accept,49
332,170,162,114.0,2.73,16,0,north_carolina_state_university_raleigh,accept,49
338,170,168,108.0,3.34,6,0,north_carolina_state_university_raleigh,accept,49
319,167,152,96.0,3.61,2,3,north_carolina_state_university_raleigh,accept,49
317,168,149,100.0,3.52,1,0,north_carolina_state_university_raleigh,accept,49
320,168,152,107.0,3.48,3,0,north_carolina_state_university_raleigh,accept,49
330,170,160,85.0,3.64,4,3,north_carolina_state_university_raleigh,accept,49
331,168,163,113.0,3.45,23,0,north_carolina_state_university_raleigh,accept,49
315,167,148,104.0,3.48,8,0,north_carolina_state_university_raleigh,accept,49
324,168,156,107.0,3.38,3,0,north_carolina_state_university_raleigh,accept,49
324,168,156,111.0,3.3,26,2,north_carolina_state_university_raleigh,accept,49
323,170,153,113.0,3.28,2,3,north_carolina_state_university_raleigh,accept,49
315,168,147,105.0,2.54,21,2,north_carolina_state_university_raleigh,accept,49
322,170,152,111.0,2.9,20,0,north_carolina_state_university_raleigh,accept,49
319,167,152,103.0,2.59,21,3,north_carolina_state_university_raleigh,accept,49
314,165,149,105.0,3.53,15,0,north_carolina_state_university_raleigh,accept,49
325,169,156,105.0,3.03,13,0,north_carolina_state_university_raleigh,accept,49
315,164,151,103.0,3.62,1,0,north_carolina_state_university_raleigh,accept,49
321,164,157,106.0,3.65,29,3,north_carolina_state_university_raleigh,accept,49
322,170,152,101.0,3.53,3,0,north_carolina_state_university_raleigh,accept,49
324,167,157,115.0,3.86,0,0,north_carolina_state_university_raleigh,accept,49
324,167,157,115.0,3.86,0,0,north_carolina_state_university_raleigh,accept,49
326,170,156,113.0,3.24,10,0,north_carolina_state_university_raleigh,accept,49
325,170,155,115.0,3.45,11,0,north_carolina_state_university_raleigh,accept,49
318,167,151,97.0,3.48,11,0,north_carolina_state_university_raleigh,accept,49
327,169,158,102.0,2.6,14,1,north_carolina_state_university_raleigh,accept,49
321,170,151,100.0,3.36,3,0,north_carolina_state_university_raleigh,accept,49
322,169,153,114,3.04,63,0,north_carolina_state_university_raleigh,accept,49
326,167,159,100.0,3.47,50,0,north_carolina_state_university_raleigh,accept,49
332,170,162,106.0,3.01,16,0,north_carolina_state_university_raleigh,accept,49
321,168,153,104.0,3.29,0,0,north_carolina_state_university_raleigh,accept,49
324,167,157,114.0,3.36,20,3,north_carolina_state_university_raleigh,accept,49
321,170,151,101.0,3.52,7,0,north_carolina_state_university_raleigh,accept,49
314,166,148,115.0,2.55,36,3,north_carolina_state_university_raleigh,accept,49
320,168,152,109.0,2.9,0,0,north_carolina_state_university_raleigh,accept,49
322,166,156,106.0,3.0,21,0,north_carolina_state_university_raleigh,accept,49
316,163,153,110.0,3.78,26,3,north_carolina_state_university_raleigh,accept,49
326,170,156,116.0,3.52,3,0,north_carolina_state_university_raleigh,accept,49
312,167,145,93.0,3.32,12,0,north_carolina_state_university_raleigh,accept,49
323,168,155,117.0,3.82,5,0,north_carolina_state_university_raleigh,accept,49
319,168,151,106.0,3.4,16,0,north_carolina_state_university_raleigh,accept,49
319,168,151,106.0,3.4,16,0,north_carolina_state_university_raleigh,accept,49
335,170,165,109.0,3.63,6,0,north_carolina_state_university_raleigh,accept,49
315,168,147,103.0,2.7,40,3,north_carolina_state_university_raleigh,accept,49
327,170,157,106.0,3.42,24,0,north_carolina_state_university_raleigh,accept,49
325,169,156,115.0,3.67,15,0,north_carolina_state_university_raleigh,accept,49
316,168,148,107.0,3.58,0,0,north_carolina_state_university_raleigh,accept,49
329,170,159,110.0,2.8,52,3,north_carolina_state_university_raleigh,accept,49
318,168,150,110.0,3.33,0,0,north_carolina_state_university_raleigh,accept,49
322,167,155,110.0,3.56,4,2,north_carolina_state_university_raleigh,accept,49
324,165,159,111.0,3.54,1,3,north_carolina_state_university_raleigh,accept,49
328,169,159,109.0,3.64,0,0,north_carolina_state_university_raleigh,accept,49
327,168,159,114.0,3.59,0,0,north_carolina_state_university_raleigh,accept,49
316,163,153,105.0,3.91,39,0,north_carolina_state_university_raleigh,accept,49
320,168,152,101.0,3.44,17,0,north_carolina_state_university_raleigh,accept,49
331,168,163,115.0,3.36,2,0,north_carolina_state_university_raleigh,accept,49
325,164,161,111.0,3.32,18,2,north_carolina_state_university_raleigh,accept,49
329,170,159,108.0,3.38,16,0,north_carolina_state_university_raleigh,accept,49
332,168,164,108.0,3.74,6,0,north_carolina_state_university_raleigh,accept,49
318,165,153,108.0,3.84,9,3,north_carolina_state_university_raleigh,accept,49
324,167,157,104.0,3.31,30,0,north_carolina_state_university_raleigh,accept,49
324,167,157,104.0,3.31,30,0,north_carolina_state_university_raleigh,accept,49
327,170,157,109.0,3.33,8,0,north_carolina_state_university_raleigh,accept,49
319,168,151,103.0,2.73,30,0,north_carolina_state_university_raleigh,accept,49
325,170,155,106.0,3.71,2,0,north_carolina_state_university_raleigh,accept,49
323,167,156,107.0,3.68,20,0,north_carolina_state_university_raleigh,accept,49
320,167,153,75.0,3.18,1,3,north_carolina_state_university_raleigh,accept,49
325,170,155,99.0,3.0,0,0,north_carolina_state_university_raleigh,accept,49
325,169,156,114.0,3.69,34,3,north_carolina_state_university_raleigh,accept,49
314,162,152,106.0,2.66,23,2,north_carolina_state_university_raleigh,accept,49
327,168,159,106.0,3.26,17,3,north_carolina_state_university_raleigh,accept,49
320,167,153,108.0,2.73,24,0,north_carolina_state_university_raleigh,accept,49
319,169,150,106.0,3.56,29,0,north_carolina_state_university_raleigh,accept,49
317,167,150,101.0,3.6,18,0,north_carolina_state_university_raleigh,accept,49
315,168,147,75.0,3.58,6,3,north_carolina_state_university_raleigh,accept,49
325,168,157,113.0,2.62,39,3,north_carolina_state_university_raleigh,accept,49
315,166,149,95.0,3.52,0,0,north_carolina_state_university_raleigh,accept,49
315,164,151,103.0,3.81,32,0,north_carolina_state_university_raleigh,accept,49
318,167,151,111.0,3.57,0,0,north_carolina_state_university_raleigh,accept,49
321,169,152,107.0,3.25,53,0,north_carolina_state_university_raleigh,accept,49
313,165,148,97.0,3.28,0,3,north_carolina_state_university_raleigh,accept,49
321,165,156,113.0,3.52,2,3,north_carolina_state_university_raleigh,accept,49
321,165,156,113.0,3.52,2,3,north_carolina_state_university_raleigh,accept,49
333,168,165,114.0,3.61,2,0,north_carolina_state_university_raleigh,accept,49
328,167,161,105.0,3.3,36,0,north_carolina_state_university_raleigh,accept,49
318,166,152,104.0,3.47,9,3,north_carolina_state_university_raleigh,accept,49
316,168,148,101.0,3.08,12,0,north_carolina_state_university_raleigh,accept,49
314,165,149,108.0,2.99,5,3,north_carolina_state_university_raleigh,accept,49
325,170,155,106.0,3.37,2,3,north_carolina_state_university_raleigh,accept,49
316,167,149,108.0,3.27,30,0,north_carolina_state_university_raleigh,accept,49
323,164,159,116.0,3.72,22,0,north_carolina_state_university_raleigh,accept,49
323,170,153,111.0,3.56,3,0,north_carolina_state_university_raleigh,accept,49
320,165,155,103.0,3.59,4,0,north_carolina_state_university_raleigh,accept,49
316,163,153,102.0,3.05,6,0,north_carolina_state_university_raleigh,accept,49
328,168,160,112.0,3.75,0,0,north_carolina_state_university_raleigh,accept,49
319,166,153,111.0,3.69,14,0,north_carolina_state_university_raleigh,accept,49
325,168,157,106.0,2.65,8,3,north_carolina_state_university_raleigh,accept,49
325,165,160,114.0,3.75,9,0,north_carolina_state_university_raleigh,accept,49
323,165,158,75.0,3.55,0,0,north_carolina_state_university_raleigh,accept,49
312,166,146,108.0,3.7,2,0,north_carolina_state_university_raleigh,accept,49
323,166,157,106.0,3.64,19,0,north_carolina_state_university_raleigh,accept,49
319,163,156,111.0,3.52,90,0,north_carolina_state_university_raleigh,accept,49
321,165,156,107.0,2.6,27,3,north_carolina_state_university_raleigh,accept,49
321,165,156,107.0,2.6,27,3,north_carolina_state_university_raleigh,accept,49
317,166,151,103.0,2.96,12,3,north_carolina_state_university_raleigh,accept,49
331,170,161,110.0,3.8,9,3,north_carolina_state_university_raleigh,accept,49
321,164,157,108.0,3.6,25,0,north_carolina_state_university_raleigh,accept,49
322,170,152,113.0,3.61,3,0,north_carolina_state_university_raleigh,accept,49
327,170,157,112.0,3.6,4,0,north_carolina_state_university_raleigh,accept,49
310,162,148,75.0,3.81,5,0,north_carolina_state_university_raleigh,accept,49
328,169,159,109.0,3.26,9,2,north_carolina_state_university_raleigh,accept,49
325,168,157,114.0,2.96,27,0,north_carolina_state_university_raleigh,accept,49
329,169,160,100.0,3.1,65,0,north_carolina_state_university_raleigh,accept,49
331,169,162,116.0,2.65,37,3,north_carolina_state_university_raleigh,accept,49
316,165,151,100.0,3.6,40,0,north_carolina_state_university_raleigh,accept,49
316,166,150,109.0,3.12,0,0,north_carolina_state_university_raleigh,accept,49
323,168,155,109.0,3.19,24,3,north_carolina_state_university_raleigh,accept,49
333,168,165,118.0,3.54,6,0,north_carolina_state_university_raleigh,accept,49
320,168,152,99.0,3.08,13,0,north_carolina_state_university_raleigh,accept,49
323,170,153,108.0,3.53,15,3,north_carolina_state_university_raleigh,accept,49
311,167,144,99.0,3.18,7,0,north_carolina_state_university_raleigh,accept,49
327,170,157,108.0,3.4,12,0,north_carolina_state_university_raleigh,accept,49
312,166,146,99.0,3.45,36,0,north_carolina_state_university_raleigh,accept,49
329,167,162,101.0,3.11,9,3,north_carolina_state_university_raleigh,accept,49
329,167,162,101.0,3.11,9,3,north_carolina_state_university_raleigh,accept,49
315,166,149,99.0,3.31,36,3,north_carolina_state_university_raleigh,accept,49
322,165,157,115.0,3.4,2,3,north_carolina_state_university_raleigh,accept,49
323,164,159,111.0,2.5,18,3,north_carolina_state_university_raleigh,accept,49
323,170,153,119.0,3.25,0,0,north_carolina_state_university_raleigh,accept,49
319,164,155,115.0,1.43,0,0,north_carolina_state_university_raleigh,accept,49
324,165,159,112.0,3.6,0,0,north_carolina_state_university_raleigh,accept,49
300,161,139,94.0,2.9,24,2,north_carolina_state_university_raleigh,accept,49
316,161,155,114.0,3.34,0,0,north_carolina_state_university_raleigh,accept,49
323,168,155,108.0,3.6,33,0,north_carolina_state_university_raleigh,accept,49
320,165,155,0,3.0,25,2,north_carolina_state_university_raleigh,accept,49
311,160,151,110.0,3.4,16,0,north_carolina_state_university_raleigh,accept,49
327,169,158,107.0,2.7,9,0,north_carolina_state_university_raleigh,accept,49
320,158,162,0,2.4,30,3,north_carolina_state_university_raleigh,accept,49
312,165,147,93.0,3.55,8,3,north_carolina_state_university_raleigh,accept,49
318,167,151,112.0,2.9,2,3,north_carolina_state_university_raleigh,accept,49
325,164,161,116.0,3.32,0,0,north_carolina_state_university_raleigh,accept,49
325,168,157,113.0,3.15,45,3,north_carolina_state_university_raleigh,accept,49
318,165,153,95.0,3.14,30,0,north_carolina_state_university_raleigh,accept,49
335,168,167,0,3.89,3,3,north_carolina_state_university_raleigh,accept,49
335,168,167,0,3.89,3,3,north_carolina_state_university_raleigh,accept,49
330,170,160,116.0,3.28,0,0,north_carolina_state_university_raleigh,accept,49
321,164,157,117.0,3.49,2,2,north_carolina_state_university_raleigh,accept,49
313,159,154,109.0,3.76,2,0,north_carolina_state_university_raleigh,accept,49
316,165,151,101.0,3.47,22,0,north_carolina_state_university_raleigh,accept,49
309,166,143,98.0,3.52,24,0,north_carolina_state_university_raleigh,accept,49
313,159,154,107.0,3.62,3,3,north_carolina_state_university_raleigh,accept,49
316,149,167,104.0,3.36,8,0,north_carolina_state_university_raleigh,accept,49
311,166,145,100.0,2.41,26,0,north_carolina_state_university_raleigh,accept,49
331,169,162,118.0,3.81,0,3,north_carolina_state_university_raleigh,accept,49
329,170,159,112.0,3.58,21,0,north_carolina_state_university_raleigh,reject,49
329,170,159,112.0,3.58,21,0,north_carolina_state_university_raleigh,reject,49
316,163,153,103.0,2.65,21,0,north_carolina_state_university_raleigh,reject,49
305,162,143,100.0,2.6,16,0,north_carolina_state_university_raleigh,reject,49
311,163,148,107.0,3.22,0,0,north_carolina_state_university_raleigh,reject,49
312,157,155,114,2.75,43,0,north_carolina_state_university_raleigh,reject,49
329,166,163,114.0,3.25,3,0,north_carolina_state_university_raleigh,reject,49
314,160,154,108.0,3.17,22,0,north_carolina_state_university_raleigh,reject,49
325,164,161,111.0,3.48,7,0,north_carolina_state_university_raleigh,reject,49
317,159,158,114.0,3.52,4,1,north_carolina_state_university_raleigh,reject,49
323,166,157,109.0,3.62,32,0,north_carolina_state_university_raleigh,reject,49
311,164,147,112.0,3.12,15,0,north_carolina_state_university_raleigh,reject,49
320,167,153,108.0,2.5,36,0,north_carolina_state_university_raleigh,reject,49
308,159,149,95.0,3.36,14,0,north_carolina_state_university_raleigh,reject,49
314,162,152,96.0,3.08,27,0,north_carolina_state_university_raleigh,reject,49
313,162,151,113.0,3.5,6,0,north_carolina_state_university_raleigh,reject,49
332,170,162,115.0,2.75,9,0,north_carolina_state_university_raleigh,reject,49
317,163,154,112.0,3.71,9,2,north_carolina_state_university_raleigh,reject,49
333,166,167,116.0,3.05,18,0,north_carolina_state_university_raleigh,reject,49
314,158,156,114,3.32,0,0,north_carolina_state_university_raleigh,reject,49
318,165,153,112.0,3.66,36,3,north_carolina_state_university_raleigh,reject,49
329,170,159,112.0,3.58,21,0,north_carolina_state_university_raleigh,reject,49
329,170,159,112.0,3.58,21,0,north_carolina_state_university_raleigh,reject,49
316,163,153,103.0,2.65,21,0,north_carolina_state_university_raleigh,reject,49
305,162,143,100.0,2.6,16,0,north_carolina_state_university_raleigh,reject,49
311,163,148,107.0,3.22,0,0,north_carolina_state_university_raleigh,reject,49
312,157,155,114,2.75,43,0,north_carolina_state_university_raleigh,reject,49
329,166,163,114.0,3.25,3,0,north_carolina_state_university_raleigh,reject,49
314,160,154,108.0,3.17,22,0,north_carolina_state_university_raleigh,reject,49
325,164,161,111.0,3.48,7,0,north_carolina_state_university_raleigh,reject,49
317,159,158,114.0,3.52,4,1,north_carolina_state_university_raleigh,reject,49
323,166,157,109.0,3.62,32,0,north_carolina_state_university_raleigh,reject,49
311,164,147,112.0,3.12,15,0,north_carolina_state_university_raleigh,reject,49
320,167,153,108.0,2.5,36,0,north_carolina_state_university_raleigh,reject,49
308,159,149,95.0,3.36,14,0,north_carolina_state_university_raleigh,reject,49
314,162,152,96.0,3.08,27,0,north_carolina_state_university_raleigh,reject,49
313,162,151,113.0,3.5,6,0,north_carolina_state_university_raleigh,reject,49
332,170,162,115.0,2.75,9,0,north_carolina_state_university_raleigh,reject,49
317,163,154,112.0,3.71,9,2,north_carolina_state_university_raleigh,reject,49
333,166,167,116.0,3.05,18,0,north_carolina_state_university_raleigh,reject,49
314,158,156,114,3.32,0,0,north_carolina_state_university_raleigh,reject,49
318,165,153,112.0,3.66,36,3,north_carolina_state_university_raleigh,reject,49
324,164,160,115.0,3.16,39,0,north_carolina_state_university_raleigh,reject,49
324,164,160,115.0,3.16,39,0,north_carolina_state_university_raleigh,reject,49
311,161,150,99.0,3.0,2,3,north_carolina_state_university_raleigh,reject,49
329,167,162,112.0,3.48,14,3,north_carolina_state_university_raleigh,reject,49
321,165,156,102.0,3.1,18,0,north_carolina_state_university_raleigh,reject,49
306,159,147,101.0,2.35,3,0,north_carolina_state_university_raleigh,reject,49
319,161,158,115.0,3.65,2,3,north_carolina_state_university_raleigh,reject,49
316,166,150,103.0,3.3,7,0,north_carolina_state_university_raleigh,reject,49
315,167,148,101,3.48,15,0,north_carolina_state_university_raleigh,reject,49
305,158,147,102.0,3.66,29,0,north_carolina_state_university_raleigh,reject,49
320,167,153,109.0,2.63,18,0,north_carolina_state_university_raleigh,reject,49
307,161,146,101.0,3.62,36,0,north_carolina_state_university_raleigh,reject,49
317,168,149,104.0,3.06,19,0,north_carolina_state_university_raleigh,reject,49
324,168,156,105.0,2.84,20,0,north_carolina_state_university_raleigh,reject,49
322,168,154,114,2.94,0,0,north_carolina_state_university_raleigh,reject,49
317,163,154,112.0,3.4,11,3,north_carolina_state_university_raleigh,reject,49
317,165,152,110.0,3.36,28,0,north_carolina_state_university_raleigh,reject,49
324,167,157,109.0,3.34,19,0,north_carolina_state_university_raleigh,reject,49
321,170,151,106.0,2.99,2,0,north_carolina_state_university_raleigh,reject,49
314,160,154,0,2.32,36,3,north_carolina_state_university_raleigh,reject,49
321,166,155,115.0,3.18,28,0,north_carolina_state_university_raleigh,reject,49
321,166,155,115.0,3.18,28,0,north_carolina_state_university_raleigh,reject,49
323,168,155,103.0,3.04,18,0,north_carolina_state_university_raleigh,reject,49
317,166,151,106.0,3.12,32,0,north_carolina_state_university_raleigh,reject,49
316,162,154,108.0,3.23,24,0,north_carolina_state_university_raleigh,reject,49
313,165,148,102.0,2.64,30,3,north_carolina_state_university_raleigh,reject,49
313,158,155,110.0,2.15,6,0,north_carolina_state_university_raleigh,reject,49
309,162,147,93.0,3.44,9,2,north_carolina_state_university_raleigh,reject,49
322,164,158,112.0,2.85,19,0,north_carolina_state_university_raleigh,reject,49
311,162,149,101,2.89,18,0,north_carolina_state_university_raleigh,reject,49
315,161,154,111.0,3.0,26,0,north_carolina_state_university_raleigh,reject,49
317,159,158,113.0,3.66,30,1,north_carolina_state_university_raleigh,reject,49
316,162,154,114.0,2.45,31,0,north_carolina_state_university_raleigh,reject,49
318,163,155,101,3.12,4,0,north_carolina_state_university_raleigh,reject,49
315,164,151,109.0,2.92,28,0,north_carolina_state_university_raleigh,reject,49
312,165,147,94.0,2.85,27,0,north_carolina_state_university_raleigh,reject,49
311,168,143,91.0,2.83,6,0,north_carolina_state_university_raleigh,reject,49
315,162,153,99.0,2.94,2,0,north_carolina_state_university_raleigh,reject,49
315,160,155,96.0,3.41,5,0,north_carolina_state_university_raleigh,reject,49
318,164,154,109.0,3.02,15,0,north_carolina_state_university_raleigh,reject,49
310,165,145,94.0,3.44,29,0,north_carolina_state_university_raleigh,reject,49
310,165,145,94.0,3.44,29,0,north_carolina_state_university_raleigh,reject,49
322,169,153,114.0,2.85,8,3,north_carolina_state_university_raleigh,reject,49
333,170,163,110.0,3.46,36,0,north_carolina_state_university_raleigh,reject,49
312,160,152,105.0,3.6,20,0,north_carolina_state_university_raleigh,reject,49
315,151,164,107.0,2.88,28,0,north_carolina_state_university_raleigh,reject,49
324,169,155,107.0,3.27,20,0,north_carolina_state_university_raleigh,reject,49
315,165,150,94.0,2.81,30,3,north_carolina_state_university_raleigh,reject,49
315,161,154,106.0,3.08,6,0,north_carolina_state_university_raleigh,reject,49
316,164,152,108.0,3.23,30,3,north_carolina_state_university_raleigh,reject,49
315,160,155,111.0,3.34,5,0,north_carolina_state_university_raleigh,reject,49
313,165,148,97.0,2.8,26,0,north_carolina_state_university_raleigh,reject,49
314,164,150,110.0,3.55,25,3,north_carolina_state_university_raleigh,reject,49
317,170,147,106.0,2.06,19,3,north_carolina_state_university_raleigh,reject,49
319,163,156,112.0,3.4,0,0,north_carolina_state_university_raleigh,reject,49
318,166,152,96.0,3.42,26,3,north_carolina_state_university_raleigh,reject,49
309,161,148,101.0,3.05,5,0,north_carolina_state_university_raleigh,reject,49
317,162,155,102.0,2.65,49,0,north_carolina_state_university_raleigh,reject,49
327,165,162,117.0,3.28,17,0,north_carolina_state_university_raleigh,reject,49
319,162,157,106.0,3.34,36,0,north_carolina_state_university_raleigh,reject,49
322,167,155,108.0,3.24,32,3,north_carolina_state_university_raleigh,reject,49
316,161,155,106.0,3.58,1,3,north_carolina_state_university_raleigh,reject,49
316,161,155,106.0,3.58,1,3,north_carolina_state_university_raleigh,reject,49
315,160,155,104.0,3.23,27,0,north_carolina_state_university_raleigh,reject,49
320,162,158,109.0,3.35,2,0,north_carolina_state_university_raleigh,reject,49
314,163,151,96.0,3.34,27,0,north_carolina_state_university_raleigh,reject,49
317,166,151,108.0,3.03,18,0,north_carolina_state_university_raleigh,reject,49
308,162,146,95.0,3.44,31,0,north_carolina_state_university_raleigh,reject,49
308,161,147,94.0,2.92,15,3,north_carolina_state_university_raleigh,reject,49
318,163,155,97.0,3.22,18,0,north_carolina_state_university_raleigh,reject,49
305,162,143,104.0,3.12,20,3,north_carolina_state_university_raleigh,reject,49
314,160,154,107.0,2.99,24,0,north_carolina_state_university_raleigh,reject,49
309,159,150,93.0,3.58,44,0,north_carolina_state_university_raleigh,reject,49
322,167,155,108.0,3.16,60,0,north_carolina_state_university_raleigh,reject,49
321,167,154,109.0,3.0,0,0,north_carolina_state_university_raleigh,reject,49
316,166,150,94.0,3.09,6,0,north_carolina_state_university_raleigh,reject,49
310,156,154,109.0,3.4,18,0,north_carolina_state_university_raleigh,reject,49
327,165,162,112.0,3.56,4,0,north_carolina_state_university_raleigh,reject,49
315,164,151,109.0,3.5,24,0,north_carolina_state_university_raleigh,reject,49
324,165,159,115.0,3.3,0,0,north_carolina_state_university_raleigh,reject,49
319,165,154,101.0,3.0,52,0,north_carolina_state_university_raleigh,reject,49
319,166,153,103.0,2.86,40,0,north_carolina_state_university_raleigh,reject,49
319,166,153,103.0,2.86,40,0,north_carolina_state_university_raleigh,reject,49
315,165,150,96.0,3.38,17,2,north_carolina_state_university_raleigh,reject,49
325,155,170,104.0,3.09,18,0,north_carolina_state_university_raleigh,reject,49
317,167,150,100.0,3.23,24,3,north_carolina_state_university_raleigh,reject,49
318,167,151,108.0,2.94,24,0,north_carolina_state_university_raleigh,reject,49
316,162,154,102.0,3.3,19,3,north_carolina_state_university_raleigh,reject,49
311,159,152,101.0,3.27,16,0,north_carolina_state_university_raleigh,reject,49
311,161,150,102.0,3.66,16,0,north_carolina_state_university_raleigh,reject,49
315,152,163,95.0,2.96,18,0,north_carolina_state_university_raleigh,reject,49
324,168,156,114.0,3.02,11,2,north_carolina_state_university_raleigh,reject,49
319,162,157,108.0,3.24,29,0,north_carolina_state_university_raleigh,reject,49
318,165,153,108.0,3.51,26,0,north_carolina_state_university_raleigh,reject,49
310,160,150,75.0,3.05,30,0,north_carolina_state_university_raleigh,reject,49
318,166,152,103.0,3.14,17,0,north_carolina_state_university_raleigh,reject,49
318,163,155,108.0,2.35,6,2,north_carolina_state_university_raleigh,reject,49
305,160,145,97.0,3.4,12,3,north_carolina_state_university_raleigh,reject,49
308,166,142,100.0,2.98,39,0,north_carolina_state_university_raleigh,reject,49
325,159,166,115.0,3.48,1,0,north_carolina_state_university_raleigh,reject,49
316,164,152,112.0,2.8,20,0,north_carolina_state_university_raleigh,reject,49
313,165,148,104.0,3.54,18,3,north_carolina_state_university_raleigh,reject,49
317,167,150,101.0,3.04,27,0,north_carolina_state_university_raleigh,reject,49
317,167,150,101.0,3.04,27,0,north_carolina_state_university_raleigh,reject,49
308,158,150,112.0,3.55,0,0,north_carolina_state_university_raleigh,reject,49
285,147,138,82.0,2.97,0,3,north_carolina_state_university_raleigh,reject,49
321,164,157,115.0,3.08,0,0,north_carolina_state_university_raleigh,reject,49
314,160,154,112.0,2.92,18,0,north_carolina_state_university_raleigh,reject,49
316,163,153,103.0,3.32,24,0,north_carolina_state_university_raleigh,reject,49
315,165,150,108.0,2.99,0,0,north_carolina_state_university_raleigh,reject,49
331,168,163,109.0,2.25,6,0,north_carolina_state_university_raleigh,reject,49
317,164,153,105.0,3.11,2,0,north_carolina_state_university_raleigh,reject,49
313,166,147,98.0,3.5,44,0,north_carolina_state_university_raleigh,reject,49
322,161,161,114.0,3.19,7,0,north_carolina_state_university_raleigh,reject,49
311,162,149,96.0,3.08,24,3,north_carolina_state_university_raleigh,reject,49
320,160,160,114,2.65,12,0,north_carolina_state_university_raleigh,reject,49
314,165,149,103.0,3.64,24,0,north_carolina_state_university_raleigh,reject,49
321,166,155,101.0,3.13,15,0,north_carolina_state_university_raleigh,reject,49
319,166,153,112.0,3.34,13,0,north_carolina_state_university_raleigh,reject,49
310,159,151,105.0,3.59,10,0,north_carolina_state_university_raleigh,reject,49
323,167,156,112.0,3.14,6,0,north_carolina_state_university_raleigh,reject,49
307,162,145,109.0,3.56,24,0,north_carolina_state_university_raleigh,reject,49
321,166,155,108.0,3.0,16,3,north_carolina_state_university_raleigh,reject,49
321,166,155,108.0,3.0,16,3,north_carolina_state_university_raleigh,reject,49
299,155,144,75.0,2.9,1,3,north_carolina_state_university_raleigh,reject,49
326,167,159,110.0,2.68,29,0,north_carolina_state_university_raleigh,reject,49
312,160,152,104.0,3.19,0,0,north_carolina_state_university_raleigh,reject,49
329,169,160,111.0,3.61,17,2,north_carolina_state_university_raleigh,reject,49
319,163,156,113.0,3.44,10,0,north_carolina_state_university_raleigh,reject,49
314,162,152,102.0,3.32,10,0,north_carolina_state_university_raleigh,reject,49
312,160,152,75.0,3.61,0,0,north_carolina_state_university_raleigh,reject,49
307,159,148,0,3.4,18,0,north_carolina_state_university_raleigh,reject,49
318,163,155,102.0,2.67,26,0,north_carolina_state_university_raleigh,reject,49
323,168,155,110.0,3.54,25,0,north_carolina_state_university_raleigh,reject,49
324,168,156,107.0,2.84,13,1,north_carolina_state_university_raleigh,reject,49
320,166,154,102.0,3.42,22,0,north_carolina_state_university_raleigh,reject,49
315,166,149,97.0,3.34,31,0,north_carolina_state_university_raleigh,reject,49
313,166,147,100.0,2.41,17,0,north_carolina_state_university_raleigh,reject,49
325,165,160,110.0,3.06,24,3,north_carolina_state_university_raleigh,reject,49
320,167,153,101.0,2.93,48,0,north_carolina_state_university_raleigh,reject,49
312,163,149,109.0,3.08,60,0,north_carolina_state_university_raleigh,reject,49
307,163,144,91.0,3.09,32,0,north_carolina_state_university_raleigh,reject,49
318,167,151,100.0,2.72,30,0,north_carolina_state_university_raleigh,reject,49
310,164,146,100.0,3.36,48,0,north_carolina_state_university_raleigh,reject,49
310,164,146,100.0,3.36,48,0,north_carolina_state_university_raleigh,reject,49
315,166,149,106.0,3.36,3,3,north_carolina_state_university_raleigh,reject,49
313,165,148,94.0,3.53,41,0,north_carolina_state_university_raleigh,reject,49
321,162,159,106.0,3.16,39,0,north_carolina_state_university_raleigh,reject,49
317,160,157,100.0,3.4,12,2,north_carolina_state_university_raleigh,reject,49
310,163,147,75.0,2.92,5,3,north_carolina_state_university_raleigh,reject,49
308,160,148,65.0,3.33,14,0,north_carolina_state_university_raleigh,reject,49
325,167,158,112.0,3.62,5,0,north_carolina_state_university_raleigh,reject,49
314,161,153,102.0,3.46,16,0,north_carolina_state_university_raleigh,reject,49
311,162,149,102.0,3.56,29,0,north_carolina_state_university_raleigh,reject,49
321,163,158,75.0,2.91,20,0,north_carolina_state_university_raleigh,reject,49
307,161,146,91.0,3.2,18,0,north_carolina_state_university_raleigh,reject,49
312,161,151,98.0,2.47,33,3,north_carolina_state_university_raleigh,reject,49
316,163,153,114,3.41,1,0,north_carolina_state_university_raleigh,reject,49
318,164,154,100.0,2.76,28,0,north_carolina_state_university_raleigh,reject,49
328,169,159,106.0,2.84,30,0,north_carolina_state_university_raleigh,reject,49
314,168,146,109.0,3.26,13,0,north_carolina_state_university_raleigh,reject,49
322,166,156,100.0,3.06,18,0,north_carolina_state_university_raleigh,reject,49
322,155,167,109.0,3.0,20,3,north_carolina_state_university_raleigh,reject,49
320,166,154,103.0,2.97,25,0,north_carolina_state_university_raleigh,reject,49
312,160,152,96.0,2.61,18,0,north_carolina_state_university_raleigh,reject,49
312,160,152,96.0,2.61,18,0,north_carolina_state_university_raleigh,reject,49
322,168,154,109.0,3.63,3,0,north_carolina_state_university_raleigh,reject,49
305,161,144,0,3.28,13,0,north_carolina_state_university_raleigh,reject,49
318,167,151,107.0,3.36,11,0,north_carolina_state_university_raleigh,reject,49
323,167,156,105.0,2.85,52,0,north_carolina_state_university_raleigh,reject,49
324,169,155,108.0,3.29,30,2,north_carolina_state_university_raleigh,reject,49
316,164,152,106.0,3.07,28,0,north_carolina_state_university_raleigh,reject,49
306,158,148,93.0,3.52,0,0,north_carolina_state_university_raleigh,reject,49
313,165,148,103.0,2.94,60,0,north_carolina_state_university_raleigh,reject,49
312,158,154,102.0,3.65,42,0,north_carolina_state_university_raleigh,reject,49
308,162,146,94.0,3.2,20,0,north_carolina_state_university_raleigh,reject,49
324,170,154,105.0,2.8,0,0,north_carolina_state_university_raleigh,reject,49
317,166,151,100.0,3.49,32,0,north_carolina_state_university_raleigh,reject,49
310,159,151,105.0,3.03,0,0,north_carolina_state_university_raleigh,reject,49
312,161,151,98.0,2.7,22,3,north_carolina_state_university_raleigh,reject,49
322,167,155,114,3.16,2,0,north_carolina_state_university_raleigh,reject,49
316,160,156,113.0,3.14,2,3,north_carolina_state_university_raleigh,reject,49
312,165,147,107.0,2.59,12,0,north_carolina_state_university_raleigh,reject,49
315,165,150,97.0,3.53,24,0,north_carolina_state_university_raleigh,reject,49
312,162,150,106.0,3.48,32,3,north_carolina_state_university_raleigh,reject,49
312,162,150,106.0,3.48,32,3,north_carolina_state_university_raleigh,reject,49
313,162,151,95.0,3.2,0,0,north_carolina_state_university_raleigh,reject,49
327,166,161,108.0,3.48,28,0,north_carolina_state_university_raleigh,reject,49
320,162,158,105.0,2.64,0,0,north_carolina_state_university_raleigh,reject,49
323,167,156,110.0,3.2,60,0,north_carolina_state_university_raleigh,reject,49
331,169,162,114.0,2.72,8,0,north_carolina_state_university_raleigh,reject,49
329,169,160,110.0,3.13,3,3,north_carolina_state_university_raleigh,reject,49
314,158,156,104.0,3.0,29,0,north_carolina_state_university_raleigh,reject,49
329,167,162,106.0,3.08,23,0,north_carolina_state_university_raleigh,reject,49
316,164,152,99.0,3.12,12,0,north_carolina_state_university_raleigh,reject,49
310,166,144,75.0,3.48,4,0,north_carolina_state_university_raleigh,reject,49
322,167,155,103.0,3.36,2,0,north_carolina_state_university_raleigh,reject,49
312,157,155,118.0,3.44,20,3,north_carolina_state_university_raleigh,reject,49
310,149,161,91.0,3.2,0,0,north_carolina_state_university_raleigh,reject,49
310,161,149,101.0,2.5,27,0,north_carolina_state_university_raleigh,reject,49
312,165,147,91.0,3.13,21,0,north_carolina_state_university_raleigh,reject,49
320,164,156,108.0,3.29,48,0,north_carolina_state_university_raleigh,reject,49
317,161,156,105.0,3.39,30,0,north_carolina_state_university_raleigh,reject,49
323,165,158,113.0,3.24,0,0,north_carolina_state_university_raleigh,reject,49
311,163,148,89.0,3.48,15,0,north_carolina_state_university_raleigh,reject,49
311,163,148,89.0,3.48,15,0,north_carolina_state_university_raleigh,reject,49
314,161,153,99.0,3.36,0,0,north_carolina_state_university_raleigh,reject,49
320,167,153,106.0,2.98,32,3,north_carolina_state_university_raleigh,reject,49
320,161,159,113.0,2.7,82,0,north_carolina_state_university_raleigh,reject,49
320,167,153,107.0,3.08,22,0,north_carolina_state_university_raleigh,reject,49
313,169,144,75.0,3.91,0,0,north_carolina_state_university_raleigh,reject,49
314,165,149,105.0,3.49,19,0,north_carolina_state_university_raleigh,reject,49
318,170,148,103.0,2.98,20,0,north_carolina_state_university_raleigh,reject,49
312,161,151,102.0,3.89,44,3,north_carolina_state_university_raleigh,reject,49
318,167,151,109.0,2.76,35,0,north_carolina_state_university_raleigh,reject,49
320,165,155,118.0,3.52,12,0,north_carolina_state_university_raleigh,reject,49
324,164,160,112.0,3.44,39,0,north_carolina_state_university_raleigh,reject,49
317,165,152,109.0,3.54,47,3,north_carolina_state_university_raleigh,reject,49
323,167,156,110.0,2.89,42,0,north_carolina_state_university_raleigh,reject,49
308,159,149,89.0,2.75,24,2,north_carolina_state_university_raleigh,reject,49
323,168,155,116.0,3.52,25,0,north_carolina_state_university_raleigh,reject,49
316,163,153,100.0,2.67,40,0,north_carolina_state_university_raleigh,reject,49
321,164,157,110.0,1.21,4,3,north_carolina_state_university_raleigh,reject,49
314,162,152,102.0,3.51,38,0,north_carolina_state_university_raleigh,reject,49
306,159,147,91.0,3.03,38,0,north_carolina_state_university_raleigh,reject,49
318,162,156,104.0,3.36,33,0,north_carolina_state_university_raleigh,reject,49
318,162,156,104.0,3.36,33,0,north_carolina_state_university_raleigh,reject,49
320,168,152,98.0,3.0,0,0,north_carolina_state_university_raleigh,reject,49
314,163,151,101,3.27,27,0,north_carolina_state_university_raleigh,reject,49
320,168,152,99.0,3.31,18,0,north_carolina_state_university_raleigh,reject,49
314,164,150,101,3.66,0,0,north_carolina_state_university_raleigh,reject,49
317,165,152,114,3.25,2,0,north_carolina_state_university_raleigh,reject,49
310,159,151,99.0,3.4,0,0,north_carolina_state_university_raleigh,reject,49
331,165,166,115.0,2.35,46,0,north_carolina_state_university_raleigh,reject,49
321,163,158,109.0,3.16,44,0,north_carolina_state_university_raleigh,reject,49
308,161,147,84.0,3.28,27,0,north_carolina_state_university_raleigh,reject,49
306,158,148,92.0,2.49,0,0,north_carolina_state_university_raleigh,reject,49
315,162,153,75.0,3.6,2,1,north_carolina_state_university_raleigh,reject,49
312,167,145,100.0,2.8,21,0,north_carolina_state_university_raleigh,reject,49
308,161,147,96.0,3.52,24,0,north_carolina_state_university_raleigh,reject,49
315,166,149,96.0,3.45,32,0,north_carolina_state_university_raleigh,reject,49
322,166,156,105.0,3.32,22,0,north_carolina_state_university_raleigh,reject,49
316,162,154,107.0,3.19,4,3,north_carolina_state_university_raleigh,reject,49
316,161,155,111.0,2.55,32,0,north_carolina_state_university_raleigh,reject,49
321,161,160,118.0,3.12,1,2,north_carolina_state_university_raleigh,reject,49
314,159,155,114.0,3.2,1,1,north_carolina_state_university_raleigh,reject,49
314,159,155,114.0,3.2,1,1,north_carolina_state_university_raleigh,reject,49
328,170,158,107.0,2.96,31,0,north_carolina_state_university_raleigh,reject,49
314,165,149,102.0,2.8,20,0,north_carolina_state_university_raleigh,reject,49
317,166,151,95.0,2.89,20,0,north_carolina_state_university_raleigh,reject,49
323,168,155,104.0,3.09,3,0,north_carolina_state_university_raleigh,reject,49
321,163,158,110.0,3.37,6,0,north_carolina_state_university_raleigh,reject,49
319,163,156,113.0,3.24,0,0,north_carolina_state_university_raleigh,reject,49
317,162,155,112.0,2.92,30,0,north_carolina_state_university_raleigh,reject,49
322,165,157,75.0,3.2,23,0,north_carolina_state_university_raleigh,reject,49
312,163,149,107.0,3.46,16,3,north_carolina_state_university_raleigh,reject,49
315,161,154,100.0,2.32,1,3,north_carolina_state_university_raleigh,reject,49
312,166,146,100.0,3.45,14,0,north_carolina_state_university_raleigh,reject,49
316,164,152,108.0,3.47,11,0,north_carolina_state_university_raleigh,reject,49
321,164,157,112.0,3.36,5,2,north_carolina_state_university_raleigh,reject,49
315,165,150,101,3.0,36,0,north_carolina_state_university_raleigh,reject,49
326,162,164,113.0,2.0,18,3,north_carolina_state_university_raleigh,reject,49
326,164,162,109.0,2.54,53,0,north_carolina_state_university_raleigh,reject,49
315,169,146,101,3.43,46,0,north_carolina_state_university_raleigh,reject,49
312,162,150,91.0,3.27,0,0,north_carolina_state_university_raleigh,reject,49
323,170,153,110.0,3.44,2,0,new_york_university,accept,22
317,164,153,111.0,2.9,17,3,new_york_university,accept,22
320,165,155,109.0,3.05,8,0,new_york_university,accept,22
317,164,153,111.0,2.9,17,3,new_york_university,accept,22
317,167,150,107.0,2.45,79,3,new_york_university,accept,22
323,165,158,108.0,3.6,2,0,new_york_university,accept,22
319,165,154,111.0,3.8,0,0,new_york_university,accept,22
325,166,159,111.0,3.84,30,0,new_york_university,accept,22
322,170,152,110.0,3.72,6,0,new_york_university,accept,22
321,167,154,115.0,3.46,4,0,new_york_university,accept,22
325,168,157,110.0,3.08,19,0,new_york_university,accept,22
332,169,163,112.0,3.44,15,3,new_york_university,accept,22
325,168,157,106.0,3.35,1,0,new_york_university,accept,22
316,167,149,89.0,2.75,19,0,new_york_university,accept,22
320,163,157,109.0,3.51,31,3,new_york_university,accept,22
322,164,158,104.0,3.2,30,0,new_york_university,accept,22
317,164,153,112.0,3.28,0,3,new_york_university,accept,22
325,168,157,112.0,2.96,40,0,new_york_university,accept,22
305,161,144,97.0,3.23,0,0,new_york_university,accept,22
305,161,144,97.0,3.23,0,0,new_york_university,accept,22
317,170,147,107.0,1.9,10,0,new_york_university,accept,22
333,165,168,117.0,2.75,30,0,new_york_university,accept,22
321,170,151,105.0,3.59,0,3,new_york_university,accept,22
325,170,155,110.0,3.0,30,0,new_york_university,accept,22
327,170,157,103.0,2.94,6,3,new_york_university,accept,22
324,165,159,105.0,3.0,30,0,new_york_university,accept,22
325,166,159,118.0,3.52,20,0,new_york_university,accept,22
316,164,152,107.0,3.31,10,3,new_york_university,accept,22
317,166,151,104.0,2.58,6,0,new_york_university,accept,22
317,167,150,108.0,2.7,6,3,new_york_university,accept,22
306,160,146,98.0,3.15,30,0,new_york_university,accept,22
311,163,148,106.0,3.9,0,2,new_york_university,accept,22
322,167,155,106.0,2.7,0,0,new_york_university,accept,22
318,163,155,108.0,2.55,10,0,new_york_university,accept,22
332,168,164,108.0,3.13,20,0,new_york_university,accept,22
318,167,151,100.0,2.4,0,0,new_york_university,accept,22
318,167,151,100.0,2.4,0,0,new_york_university,accept,22
329,169,160,111.0,3.13,0,3,new_york_university,accept,22
313,163,150,114.0,3.37,0,3,new_york_university,accept,22
320,170,150,102.0,2.6,20,0,new_york_university,accept,22
312,167,145,93.0,3.32,12,0,new_york_university,accept,22
312,167,145,93.0,3.32,12,0,new_york_university,accept,22
326,167,159,116.0,2.74,18,0,new_york_university,accept,22
329,167,162,116.0,2.75,13,0,new_york_university,accept,22
316,164,152,109.0,2.83,1,0,new_york_university,accept,22
322,167,155,112.0,3.5,16,3,new_york_university,accept,22
321,166,155,101.0,3.52,0,0,new_york_university,accept,22
324,169,155,110.0,2.51,13,3,new_york_university,accept,22
325,168,157,113.0,3.72,9,0,new_york_university,accept,22
327,167,160,109.0,2.88,24,0,new_york_university,accept,22
324,168,156,114.0,3.26,44,3,new_york_university,accept,22
318,164,154,106.0,2.82,6,0,new_york_university,accept,22
321,167,154,104.0,3.3,5,0,new_york_university,accept,22
311,160,151,103.0,3.59,22,3,new_york_university,accept,22
329,170,159,114.0,3.12,0,0,new_york_university,accept,22
319,161,158,115.0,3.65,2,3,new_york_university,accept,22
319,161,158,115.0,3.65,2,3,new_york_university,accept,22
316,164,152,92.0,3.24,27,2,new_york_university,accept,22
326,165,161,113.0,2.98,1,0,new_york_university,accept,22
319,163,156,113.0,3.44,10,0,new_york_university,accept,22
318,167,151,109.0,3.88,2,0,new_york_university,accept,22
316,167,149,101.0,3.35,0,0,new_york_university,accept,22
325,169,156,116.0,3.62,4,3,new_york_university,accept,22
311,164,147,112.0,3.12,15,0,new_york_university,accept,22
316,161,155,111.0,2.55,32,0,new_york_university,accept,22
311,160,151,105.0,3.43,2,0,new_york_university,accept,22
322,162,160,114,3.17,0,0,new_york_university,accept,22
325,168,157,115.0,3.31,18,3,new_york_university,accept,22
323,165,158,75.0,3.58,40,3,new_york_university,accept,22
330,167,163,114.0,2.4,6,0,new_york_university,accept,22
314,164,150,0,3.03,0,0,new_york_university,accept,22
311,162,149,111.0,2.77,18,3,new_york_university,accept,22
318,166,152,0,3.35,28,0,new_york_university,accept,22
320,166,154,0,3.42,1,0,new_york_university,accept,22
325,170,155,106.0,2.59,31,0,new_york_university,accept,22
309,159,150,0,2.8,17,3,new_york_university,accept,22
321,169,152,108.0,3.4,3,2,new_york_university,accept,22
320,165,155,107.0,3.12,24,3,new_york_university,accept,22
316,163,153,0,2.68,15,3,new_york_university,accept,22
319,163,156,117.0,4.0,3,0,new_york_university,accept,22
319,167,152,111.0,3.56,0,0,new_york_university,accept,22
325,164,161,117.0,3.33,10,0,new_york_university,accept,22
330,170,160,105.0,3.84,6,0,new_york_university,accept,22
324,167,157,107.0,3.71,1,0,new_york_university,accept,22
310,162,148,106.0,3.44,12,3,new_york_university,accept,22
325,167,158,112.0,3.28,41,0,new_york_university,accept,22
327,168,159,115.0,2.8,15,0,new_york_university,accept,22
334,170,164,116.0,3.64,25,0,new_york_university,accept,22
330,169,161,0,2.78,8,2,new_york_university,accept,22
319,170,149,107.0,3.63,24,3,new_york_university,accept,22
320,165,155,117.0,2.9,0,0,new_york_university,accept,22
322,168,154,111.0,3.58,18,3,new_york_university,accept,22
330,170,160,0,3.2,0,0,new_york_university,accept,22
333,170,163,111.0,3.28,39,0,new_york_university,accept,22
323,167,156,110.0,3.0,29,0,new_york_university,accept,22
322,167,155,113.0,3.56,0,0,new_york_university,accept,22
325,168,157,0,3.56,21,0,new_york_university,accept,22
334,170,164,0,3.28,8,3,new_york_university,accept,22
330,168,162,116.0,3.44,9,0,new_york_university,accept,22
315,168,147,106.0,3.6,2,0,new_york_university,accept,22
330,170,160,111.0,3.32,28,0,new_york_university,accept,22
320,165,155,0,3.6,0,0,new_york_university,accept,22
314,161,153,105.0,2.65,18,0,new_york_university,accept,22
304,160,144,99.0,3.6,0,0,new_york_university,accept,22
309,164,145,99.0,2.69,3,3,new_york_university,accept,22
315,165,150,114.0,3.14,21,0,new_york_university,accept,22
306,160,146,96.0,3.33,28,0,new_york_university,accept,22
311,162,149,105.0,2.45,0,0,new_york_university,accept,22
315,162,153,95.0,3.24,3,2,new_york_university,accept,22
325,168,157,108.0,2.5,0,0,new_york_university,accept,22
315,165,150,103.0,2.55,42,0,new_york_university,accept,22
315,165,150,103.0,2.55,42,0,new_york_university,accept,22
320,166,154,110.0,3.26,2,0,new_york_university,accept,22
324,170,154,111.0,2.85,5,3,new_york_university,accept,22
324,156,168,111.0,2.25,0,0,new_york_university,accept,22
310,163,147,95.0,3.25,4,0,new_york_university,accept,22
317,165,152,105.0,3.41,1,3,new_york_university,accept,22
326,170,156,110.0,3.28,4,0,new_york_university,accept,22
312,163,149,98.0,3.5,14,0,new_york_university,accept,22
312,160,152,96.0,2.45,39,0,new_york_university,accept,22
306,161,145,98.0,2.21,36,0,new_york_university,accept,22
318,162,156,108.0,3.26,30,3,new_york_university,accept,22
307,161,146,100.0,2.15,20,0,new_york_university,accept,22
309,156,153,85.0,2.75,1,0,new_york_university,accept,22
322,165,157,116.0,3.22,40,0,new_york_university,accept,22
318,163,155,111.0,3.09,4,3,new_york_university,accept,22
321,164,157,111.0,2.68,23,0,new_york_university,accept,22
321,164,157,111.0,2.68,23,0,new_york_university,accept,22
325,168,157,110.0,3.1,6,3,new_york_university,accept,22
318,166,152,104.0,3.44,32,0,new_york_university,accept,22
322,167,155,112.0,3.49,8,3,new_york_university,accept,22
331,170,161,113.0,3.44,3,0,new_york_university,accept,22
331,170,161,112.0,3.55,2,0,new_york_university,accept,22
309,160,149,105.0,2.62,15,1,new_york_university,accept,22
320,166,154,110.0,3.56,3,0,new_york_university,accept,22
321,168,153,111.0,3.15,32,3,new_york_university,accept,22
317,163,154,112.0,3.6,21,2,new_york_university,accept,22
318,168,150,106.0,3.55,15,3,new_york_university,accept,22
317,167,150,104.0,2.65,45,0,new_york_university,accept,22
314,163,151,114,3.53,7,3,new_york_university,reject,22
314,163,151,114,3.53,7,3,new_york_university,reject,22
316,159,157,104.0,1.89,43,0,new_york_university,reject,22
316,161,155,109.0,2.68,32,2,new_york_university,reject,22
319,168,151,95.0,2.2,32,3,new_york_university,reject,22
320,168,152,110.0,3.14,3,0,new_york_university,reject,22
315,165,150,114.0,3.8,1,0,new_york_university,reject,22
325,168,157,105.0,2.95,28,0,new_york_university,reject,22
318,166,152,117.0,3.66,0,0,new_york_university,reject,22
325,168,157,116.0,3.46,2,0,new_york_university,reject,22
334,169,165,108.0,2.96,26,0,new_york_university,reject,22
329,169,160,108.0,3.51,21,0,new_york_university,reject,22
337,169,168,107.0,3.25,18,0,new_york_university,reject,22
314,165,149,105.0,3.49,19,0,new_york_university,reject,22
323,163,160,112.0,3.5,2,0,new_york_university,reject,22
316,165,151,95.0,3.27,10,0,new_york_university,reject,22
313,162,151,92.0,3.31,1,3,new_york_university,reject,22
313,162,151,92.0,3.31,1,3,new_york_university,reject,22
306,160,146,94.0,3.34,18,3,new_york_university,reject,22
321,168,153,97.0,3.19,19,1,new_york_university,reject,22
308,164,144,96.0,2.64,4,0,new_york_university,reject,22
322,166,156,110.0,3.28,19,0,new_york_university,reject,22
333,168,165,115.0,3.16,2,0,new_york_university,reject,22
295,155,140,92.0,2.23,43,0,new_york_university,reject,22
311,162,149,99.0,2.8,0,0,new_york_university,reject,22
301,150,151,89.0,3.2,50,0,new_york_university,reject,22
324,169,155,108.0,3.29,30,2,new_york_university,reject,22
316,160,156,103.0,2.7,16,1,new_york_university,reject,22
313,163,150,97.0,2.52,19,0,new_york_university,reject,22
323,160,163,108.0,3.02,19,0,new_york_university,reject,22
305,160,145,92.0,3.12,24,1,new_york_university,reject,22
320,165,155,112.0,2.72,1,0,new_york_university,reject,22
317,168,149,108.0,3.32,79,0,new_york_university,reject,22
318,165,153,108.0,2.3,24,0,new_york_university,reject,22
312,165,147,88.0,3.14,50,3,new_york_university,reject,22
320,167,153,109.0,3.05,16,0,new_york_university,reject,22
311,165,146,95.0,3.52,0,0,new_york_university,reject,22
312,157,155,106.0,3.24,46,0,new_york_university,reject,22
317,170,147,106.0,3.19,24,0,new_york_university,reject,22
311,163,148,98.0,3.0,54,0,new_york_university,reject,22
312,166,146,99.0,3.45,36,0,new_york_university,reject,22
321,167,154,112.0,3.44,37,0,new_york_university,reject,22
309,159,150,104.0,3.14,17,0,new_york_university,reject,22
324,167,157,105.0,2.88,2,0,new_york_university,reject,22
319,162,157,112.0,1.9,60,0,new_york_university,reject,22
323,168,155,104.0,3.43,24,3,new_york_university,reject,22
319,163,156,110.0,2.88,2,0,new_york_university,reject,22
331,170,161,112.0,3.2,28,0,new_york_university,reject,22
312,164,148,97.0,3.65,27,3,new_york_university,reject,22
310,160,150,111.0,2.95,2,0,new_york_university,reject,22
316,162,154,106.0,3.52,16,0,new_york_university,reject,22
311,161,150,101.0,3.36,0,0,new_york_university,reject,22
320,163,157,110.0,3.26,16,0,new_york_university,reject,22
316,164,152,108.0,3.06,30,0,new_york_university,reject,22
291,143,148,95.0,3.2,0,0,new_york_university,reject,22
323,170,153,102.0,3.6,4,0,new_york_university,reject,22
322,164,158,105.0,3.06,6,3,new_york_university,reject,22
317,164,153,103.0,3.06,22,0,new_york_university,reject,22
309,159,150,99.0,3.2,42,0,new_york_university,reject,22
319,164,155,112.0,2.6,5,0,new_york_university,reject,22
314,161,153,98.0,2.98,0,0,new_york_university,reject,22
324,167,157,110.0,2.99,0,0,new_york_university,reject,22
328,170,158,111.0,2.75,5,0,new_york_university,reject,22
320,170,150,105.0,3.5,26,0,new_york_university,reject,22
326,169,157,108.0,3.26,0,0,new_york_university,reject,22
326,169,157,108.0,3.26,0,0,new_york_university,reject,22
320,165,155,108.0,3.4,18,0,new_york_university,reject,22
326,168,158,0,3.22,1,3,new_york_university,reject,22
316,163,153,104.0,3.68,18,0,new_york_university,reject,22
328,165,163,109.0,3.57,6,0,new_york_university,reject,22
322,161,161,109.0,2.9,7,1,new_york_university,reject,22
326,163,163,110.0,3.34,24,0,new_york_university,reject,22
319,164,155,109.0,2.88,4,0,new_york_university,reject,22
302,156,146,103.0,2.2,39,0,new_york_university,reject,22
322,166,156,0,3.21,5,3,new_york_university,reject,22
311,164,147,102.0,3.02,27,3,new_york_university,reject,22
320,170,150,107.0,3.66,54,0,new_york_university,reject,22
326,170,156,111.0,3.47,20,0,new_york_university,reject,22
314,157,157,111.0,3.21,0,0,new_york_university,reject,22
319,164,155,114,2.37,0,0,new_york_university,reject,22
320,169,151,75.0,3.4,17,0,new_york_university,reject,22
314,161,153,0,2.83,17,3,new_york_university,reject,22
314,161,153,0,2.83,17,3,new_york_university,reject,22
317,165,152,0,3.34,24,3,new_york_university,reject,22
310,159,151,103.0,3.18,39,0,new_york_university,reject,22
311,157,154,108.0,3.05,24,0,new_york_university,reject,22
310,158,152,96.0,2.25,33,0,new_york_university,reject,22
312,156,156,93.0,2.05,41,0,new_york_university,reject,22
312,159,153,112.0,2.46,15,2,new_york_university,reject,22
304,155,149,92.0,2.59,38,0,new_york_university,reject,22
310,164,146,108.0,2.48,9,3,new_york_university,reject,22
302,157,145,96.0,2.88,16,3,new_york_university,reject,22
309,159,150,108.0,2.7,12,2,new_york_university,reject,22
321,164,157,115.0,2.76,18,0,new_york_university,reject,22
320,164,156,105.0,2.84,30,0,new_york_university,reject,22
329,167,162,110.0,3.09,31,0,new_york_university,reject,22
310,164,146,105.0,2.88,35,0,new_york_university,reject,22
311,166,145,98.0,2.15,0,0,new_york_university,reject,22
320,159,161,111.0,2.77,52,0,new_york_university,reject,22
304,163,141,85.0,3.2,9,3,new_york_university,reject,22
313,163,150,104.0,2.15,74,0,new_york_university,reject,22
315,165,150,105.0,2.8,6,3,new_york_university,reject,22
323,164,159,118.0,2.6,6,0,new_york_university,reject,22
317,158,159,104.0,2.95,62,0,new_york_university,reject,22
322,168,154,102.0,2.5,2,0,new_york_university,reject,22
319,164,155,110.0,2.71,37,0,new_york_university,reject,22
317,168,149,99.0,2.96,2,0,new_york_university,reject,22
319,170,149,89.0,3.2,3,0,new_york_university,reject,22
308,164,144,94.0,2.52,36,3,new_york_university,reject,22
319,167,152,0,2.7,0,0,new_york_university,reject,22
316,166,150,92.0,3.16,30,3,new_york_university,reject,22
323,170,153,112.0,3.53,3,0,new_york_university,reject,22
327,170,157,115.0,3.04,12,0,new_york_university,reject,22
329,167,162,117.0,3.08,36,0,new_york_university,reject,22
311,158,153,98.0,2.9,0,0,new_york_university,reject,22
321,163,158,116.0,2.64,6,3,new_york_university,reject,22
316,170,146,100.0,3.2,25,0,new_york_university,reject,22
312,160,152,109.0,3.46,63,0,new_york_university,reject,22
320,162,158,111.0,3.36,8,3,new_york_university,reject,22
315,162,153,106.0,2.3,60,0,new_york_university,reject,22
294,157,137,87.0,2.75,60,0,new_york_university,reject,22
330,167,163,114.0,2.88,28,0,new_york_university,reject,22
310,158,152,109.0,2.49,29,0,new_york_university,reject,22
310,158,152,109.0,2.49,29,0,new_york_university,reject,22
312,162,150,101.0,1.83,46,3,new_york_university,reject,22
321,162,159,111.0,2.75,14,0,new_york_university,reject,22
314,165,149,108.0,3.19,4,0,new_york_university,reject,22
313,160,153,104.0,3.37,2,2,new_york_university,reject,22
318,170,148,113.0,3.2,12,0,new_york_university,reject,22
304,163,141,85.0,3.2,14,3,new_york_university,reject,22
320,163,157,113.0,2.89,18,0,new_york_university,reject,22
322,168,154,108.0,2.68,24,0,new_york_university,reject,22
310,162,148,97.0,3.2,0,0,new_york_university,reject,22
311,164,147,91.0,2.88,0,0,new_york_university,reject,22
307,158,149,89.0,3.28,7,0,new_york_university,reject,22
305,156,149,107.0,2.76,0,0,new_york_university,reject,22
303,157,146,100.0,2.52,0,0,new_york_university,reject,22
316,166,150,107.0,3.28,40,1,new_york_university,reject,22
324,167,157,112.0,2.96,39,0,new_york_university,reject,22
307,158,149,97.0,3.34,0,0,new_york_university,reject,22
307,158,149,97.0,3.34,0,0,new_york_university,reject,22
308,156,152,112.0,2.88,0,0,new_york_university,reject,22
300,144,156,92.0,2.98,2,3,new_york_university,reject,22
311,165,146,90.0,3.13,4,2,new_york_university,reject,22
327,170,157,117.0,3.28,6,3,new_york_university,reject,22
328,170,158,107.0,2.57,18,0,new_york_university,reject,22
325,168,157,113.0,2.07,14,2,new_york_university,reject,22
312,162,150,99.0,2.72,6,0,new_york_university,reject,22
289,145,144,80.0,2.47,12,3,new_york_university,reject,22
317,154,163,107.0,2.5,13,0,new_york_university,reject,22
318,165,153,106.0,2.75,0,1,new_york_university,reject,22
308,160,148,97.0,2.2,12,3,new_york_university,reject,22
323,163,160,114.0,3.79,30,0,new_york_university,reject,22
332,170,162,110.0,2.64,36,0,new_york_university,reject,22
328,167,161,117.0,3.08,0,3,new_york_university,reject,22
326,165,161,111.0,2.37,48,0,new_york_university,reject,22
326,165,161,111.0,2.37,48,0,new_york_university,reject,22
323,166,157,108.0,2.97,2,3,new_york_university,reject,22
326,167,159,106.0,2.98,19,0,new_york_university,reject,22
321,170,151,111.0,2.8,30,0,new_york_university,reject,22
322,167,155,113.0,2.95,10,2,new_york_university,reject,22
318,170,148,101.0,3.2,20,3,new_york_university,reject,22
320,167,153,108.0,2.75,0,3,new_york_university,reject,22
321,165,156,100.0,2.9,40,0,new_york_university,reject,22
329,170,159,109.0,2.99,2,0,new_york_university,reject,22
323,168,155,100.0,3.07,20,3,new_york_university,reject,22
316,160,156,111.0,3.9,24,0,new_york_university,reject,22
318,164,154,107.0,3.16,0,0,new_york_university,reject,22
316,164,152,106.0,3.26,18,2,new_york_university,reject,22
320,168,152,112.0,2.8,12,0,new_york_university,reject,22
318,160,158,113.0,3.52,24,0,new_york_university,reject,22
323,156,167,117.0,2.1,22,0,new_york_university,reject,22
325,170,155,108.0,2.88,24,0,new_york_university,reject,22
311,167,144,98.0,3.66,1,0,new_york_university,reject,22
321,167,154,108.0,2.7,10,0,new_york_university,reject,22
317,163,154,110.0,3.69,10,0,new_york_university,reject,22
303,154,149,106.0,1.95,30,0,new_york_university,reject,22
326,170,156,113.0,1.47,0,0,new_york_university,reject,22
313,157,156,106.0,2.35,10,0,new_york_university,reject,22
316,164,152,99.0,3.12,12,0,northeastern_university,reject,15
316,164,152,99.0,3.12,12,0,northeastern_university,reject,15
316,160,156,114,2.97,0,0,northeastern_university,reject,15
317,168,149,106.0,2.83,15,0,northeastern_university,reject,15
317,161,156,106.0,2.01,0,0,northeastern_university,reject,15
299,151,148,101,3.0,35,0,northeastern_university,reject,15
325,168,157,105.0,2.95,28,0,northeastern_university,reject,15
314,164,150,103.0,3.2,3,1,northeastern_university,reject,15
326,165,161,109.0,2.59,1,3,northeastern_university,reject,15
328,169,159,106.0,2.84,30,0,northeastern_university,reject,15
322,163,159,106.0,2.71,2,2,northeastern_university,reject,15
300,160,140,99.0,2.71,24,3,northeastern_university,reject,15
312,162,150,102.0,2.52,30,3,northeastern_university,reject,15
316,159,157,104.0,1.89,43,0,northeastern_university,reject,15
322,162,160,114.0,2.76,16,2,northeastern_university,reject,15
316,164,152,99.0,3.12,12,0,northeastern_university,reject,15
316,164,152,99.0,3.12,12,0,northeastern_university,reject,15
316,160,156,114,2.97,0,0,northeastern_university,reject,15
317,168,149,106.0,2.83,15,0,northeastern_university,reject,15
317,161,156,106.0,2.01,0,0,northeastern_university,reject,15
299,151,148,101,3.0,35,0,northeastern_university,reject,15
325,168,157,105.0,2.95,28,0,northeastern_university,reject,15
314,164,150,103.0,3.2,3,1,northeastern_university,reject,15
326,165,161,109.0,2.59,1,3,northeastern_university,reject,15
328,169,159,106.0,2.84,30,0,northeastern_university,reject,15
322,163,159,106.0,2.71,2,2,northeastern_university,reject,15
300,160,140,99.0,2.71,24,3,northeastern_university,reject,15
312,162,150,102.0,2.52,30,3,northeastern_university,reject,15
316,159,157,104.0,1.89,43,0,northeastern_university,reject,15
322,162,160,114.0,2.76,16,2,northeastern_university,reject,15
307,166,141,80.0,3.4,60,2,northeastern_university,reject,15
330,168,162,113.0,2.98,34,2,northeastern_university,reject,15
313,162,151,92.0,3.31,1,3,northeastern_university,reject,15
313,162,151,92.0,3.31,1,3,northeastern_university,reject,15
312,157,155,94.0,3.34,12,2,northeastern_university,reject,15
321,164,157,110.0,1.21,4,3,northeastern_university,reject,15
287,149,138,83.0,2.73,25,0,northeastern_university,reject,15
315,158,157,113.0,2.38,17,2,northeastern_university,reject,15
310,161,149,102.0,2.79,31,3,northeastern_university,reject,15
312,164,148,101,3.0,30,0,northeastern_university,reject,15
321,169,152,105.0,2.47,6,3,northeastern_university,reject,15
327,169,158,106.0,2.84,41,0,northeastern_university,reject,15
311,163,148,101,3.4,10,0,northeastern_university,reject,15
304,153,151,104.0,2.85,24,0,northeastern_university,reject,15
309,163,146,96.0,3.48,12,0,northeastern_university,reject,15
300,157,143,99.0,3.3,30,0,northeastern_university,reject,15
324,167,157,101.0,2.56,82,3,northeastern_university,reject,15
312,157,155,110.0,2.86,25,3,northeastern_university,reject,15
309,168,141,103.0,3.48,2,0,northeastern_university,reject,15
310,158,152,97.0,2.26,57,0,northeastern_university,reject,15
311,162,149,99.0,2.95,0,3,northeastern_university,reject,15
315,165,150,97.0,3.53,24,0,northeastern_university,reject,15
303,156,147,100.0,2.76,53,2,northeastern_university,reject,15
307,157,150,93.0,3.05,25,0,northeastern_university,reject,15
313,166,147,106.0,3.28,1,3,northeastern_university,reject,15
322,170,152,101.0,2.81,25,3,northeastern_university,reject,15
309,168,141,98.0,3.16,9,0,northeastern_university,reject,15
308,159,149,95.0,3.36,14,0,northeastern_university,reject,15
304,160,144,95.0,3.52,0,0,northeastern_university,reject,15
311,166,145,97.0,3.35,0,0,northeastern_university,reject,15
310,161,149,95.0,3.16,0,0,northeastern_university,reject,15
311,159,152,93.0,2.94,15,0,northeastern_university,reject,15
304,161,143,94.0,3.55,46,0,northeastern_university,reject,15
310,158,152,103.0,2.08,60,0,northeastern_university,reject,15
302,159,143,92.0,3.28,0,0,northeastern_university,reject,15
305,145,160,101.0,1.95,50,2,northeastern_university,reject,15
307,163,144,65.0,2.4,40,0,northeastern_university,reject,15
317,170,147,96.0,3.16,31,0,northeastern_university,reject,15
302,160,142,86.0,2.56,60,0,northeastern_university,reject,15
308,161,147,96.0,3.52,24,0,northeastern_university,reject,15
306,160,146,94.0,3.34,18,3,northeastern_university,reject,15
305,163,142,91.0,2.6,45,0,northeastern_university,reject,15
312,165,147,91.0,2.6,60,0,northeastern_university,reject,15
305,155,150,94.0,2.59,19,0,northeastern_university,reject,15
310,157,153,96.0,2.92,13,3,northeastern_university,reject,15
313,164,149,90.0,3.28,15,1,northeastern_university,reject,15
313,162,151,95.0,3.2,0,0,northeastern_university,reject,15
314,163,151,95.0,2.51,60,0,northeastern_university,reject,15
312,161,151,96.0,2.75,18,0,northeastern_university,reject,15
308,164,144,90.0,3.37,0,0,northeastern_university,reject,15
307,158,149,114,2.63,34,0,northeastern_university,reject,15
319,170,149,86.0,3.68,13,0,northeastern_university,reject,15
319,170,149,86.0,3.68,13,0,northeastern_university,reject,15
314,166,148,89.0,2.67,13,2,northeastern_university,reject,15
308,165,143,96.0,2.2,92,0,northeastern_university,reject,15
310,160,150,93.0,3.6,1,0,northeastern_university,reject,15
317,161,156,75.0,3.12,0,0,northeastern_university,reject,15
312,167,145,100.0,2.8,21,0,northeastern_university,reject,15
320,161,159,75.0,2.44,1,0,northeastern_university,reject,15
305,161,144,98.0,2.78,2,0,northeastern_university,reject,15
316,164,152,107.0,3.44,3,0,northeastern_university,reject,15
319,169,150,105.0,3.3,0,0,northeastern_university,reject,15
292,155,137,65.0,2.68,5,1,northeastern_university,reject,15
315,166,149,99.0,3.08,12,0,northeastern_university,reject,15
311,165,146,95.0,3.52,0,0,northeastern_university,reject,15
312,160,152,109.0,3.4,7,0,northeastern_university,reject,15
293,157,136,87.0,2.0,15,0,northeastern_university,reject,15
318,164,154,108.0,2.4,46,0,northeastern_university,reject,15
318,164,154,108.0,2.4,46,0,northeastern_university,reject,15
319,170,149,108.0,2.64,42,0,northeastern_university,reject,15
306,159,147,97.0,3.32,24,3,northeastern_university,reject,15
303,160,143,89.0,3.0,0,0,northeastern_university,reject,15
309,158,151,0,2.48,60,0,northeastern_university,reject,15
303,160,143,101,2.1,0,0,northeastern_university,reject,15
320,160,160,82.0,3.45,10,0,northeastern_university,reject,15
302,153,149,91.0,2.56,110,0,northeastern_university,reject,15
313,164,149,96.0,2.46,7,0,northeastern_university,reject,15
303,159,144,92.0,3.15,26,0,northeastern_university,reject,15
322,169,153,113.0,2.89,2,0,northeastern_university,reject,15
305,158,147,82.0,2.97,25,3,northeastern_university,reject,15
305,159,146,101,3.45,37,0,northeastern_university,reject,15
302,158,144,92.0,2.85,48,0,northeastern_university,reject,15
329,168,161,113.0,3.06,40,0,northeastern_university,reject,15
308,155,153,114,2.9,1,3,northeastern_university,reject,15
308,157,151,101.0,3.18,0,1,northeastern_university,reject,15
308,157,151,101.0,3.18,0,1,northeastern_university,reject,15
325,167,158,109.0,3.06,0,0,northeastern_university,reject,15
319,162,157,112.0,1.9,60,0,northeastern_university,reject,15
319,164,155,115.0,1.43,0,0,northeastern_university,reject,15
321,164,157,106.0,3.21,14,0,northeastern_university,reject,15
293,156,137,79.0,2.0,63,0,northeastern_university,reject,15
313,163,150,116.0,2.99,2,0,northeastern_university,reject,15
309,167,142,96.0,2.47,0,0,northeastern_university,reject,15
308,165,143,101,3.57,24,2,northeastern_university,reject,15
318,166,152,75.0,3.27,0,0,northeastern_university,reject,15
302,154,148,101,3.0,2,0,northeastern_university,reject,15
317,165,152,101.0,2.35,18,3,northeastern_university,reject,15
312,163,149,87.0,2.81,30,1,northeastern_university,reject,15
318,166,152,0,3.35,28,0,northeastern_university,reject,15
322,165,157,110.0,2.4,30,0,northeastern_university,reject,15
306,157,149,0,2.1,11,3,northeastern_university,reject,15
324,167,157,110.0,3.37,15,0,northeastern_university,reject,15
316,166,150,96.0,2.52,34,0,northeastern_university,reject,15
304,157,147,94.0,3.28,0,0,northeastern_university,reject,15
319,170,149,0,2.54,8,0,northeastern_university,reject,15
311,161,150,100.0,2.65,31,0,northeastern_university,reject,15
320,163,157,114.0,2.92,0,0,northeastern_university,reject,15
315,164,151,0,2.3,30,0,northeastern_university,reject,15
319,164,155,114.0,3.23,60,0,northeastern_university,reject,15
311,162,149,114,2.71,18,0,northeastern_university,reject,15
303,158,145,99.0,3.86,12,0,northeastern_university,reject,15
314,162,152,106.0,3.36,6,0,northeastern_university,reject,15
319,166,153,91.0,3.14,0,3,northeastern_university,reject,15
317,166,151,105.0,3.23,8,0,northeastern_university,reject,15
318,165,153,95.0,3.14,30,0,northeastern_university,reject,15
307,160,147,95.0,2.25,60,0,northeastern_university,reject,15
311,163,148,101,3.68,24,3,northeastern_university,reject,15
312,166,146,99.0,2.6,27,0,northeastern_university,reject,15
303,142,161,101,3.7,19,0,northeastern_university,reject,15
313,160,153,0,3.36,0,0,northeastern_university,reject,15
313,163,150,0,3.08,0,0,northeastern_university,reject,15
314,162,152,105.0,2.9,2,0,northeastern_university,reject,15
288,153,135,79.0,2.94,19,3,northeastern_university,reject,15
303,157,146,101,3.1,23,0,northeastern_university,reject,15
312,166,146,93.0,3.31,55,0,northeastern_university,reject,15
319,165,154,110.0,3.88,1,3,northeastern_university,reject,15
313,169,144,100.0,2.96,3,0,northeastern_university,reject,15
317,169,148,96.0,2.98,24,3,northeastern_university,reject,15
313,162,151,102.0,3.12,1,0,northeastern_university,reject,15
308,160,148,0,2.84,1,0,northeastern_university,reject,15
310,163,147,0,3.24,14,3,northeastern_university,reject,15
315,166,149,98.0,3.36,1,3,northeastern_university,reject,15
322,165,157,111.0,2.15,20,0,northeastern_university,reject,15
312,164,148,97.0,3.65,27,3,northeastern_university,reject,15
310,160,150,97.0,3.51,41,0,northeastern_university,reject,15
322,161,161,109.0,2.9,7,1,northeastern_university,reject,15
312,147,165,106.0,2.75,15,3,northeastern_university,reject,15
312,147,165,106.0,2.75,15,3,northeastern_university,reject,15
320,164,156,0,2.55,51,0,northeastern_university,reject,15
313,165,148,75.0,3.09,0,0,northeastern_university,reject,15
316,163,153,110.0,3.56,23,0,northeastern_university,reject,15
300,156,144,93.0,3.62,24,0,northeastern_university,reject,15
321,167,154,113.0,2.1,24,0,northeastern_university,reject,15
323,163,160,110.0,2.96,0,0,northeastern_university,reject,15
301,153,148,95.0,1.82,12,3,northeastern_university,reject,15
313,163,150,96.0,3.44,28,0,northeastern_university,reject,15
310,165,145,104.0,2.96,5,0,northeastern_university,reject,15
303,158,145,101.0,3.62,0,3,northeastern_university,reject,15
311,161,150,101.0,3.36,0,0,northeastern_university,reject,15
304,156,148,102.0,3.05,42,0,northeastern_university,reject,15
323,156,167,107.0,3.02,36,0,northeastern_university,reject,15
308,160,148,103.0,3.42,24,0,northeastern_university,reject,15
308,160,148,103.0,3.42,24,0,northeastern_university,reject,15
307,162,145,105.0,2.13,4,3,northeastern_university,reject,15
304,160,144,99.0,3.6,0,0,northeastern_university,reject,15
315,164,151,108.0,3.17,8,0,northeastern_university,reject,15
315,161,154,112.0,2.36,12,3,northeastern_university,reject,15
313,161,152,110.0,3.05,4,0,northeastern_university,reject,15
318,167,151,104.0,3.12,13,0,northeastern_university,reject,15
308,156,152,0,2.77,28,0,northeastern_university,reject,15
306,154,152,109.0,3.41,0,0,northeastern_university,reject,15
314,161,153,100.0,2.2,0,0,northeastern_university,reject,15
319,164,155,112.0,2.6,5,0,northeastern_university,reject,15
310,158,152,96.0,2.54,1,3,northeastern_university,reject,15
304,160,144,99.0,3.1,2,0,northeastern_university,reject,15
310,161,149,0,3.52,0,0,northeastern_university,reject,15
320,167,153,0,3.04,1,2,northeastern_university,reject,15
312,163,149,107.0,3.42,30,0,northeastern_university,reject,15
318,163,155,110.0,3.33,51,0,northeastern_university,reject,15
313,161,152,0,2.53,17,0,northeastern_university,reject,15
310,159,151,103.0,3.31,15,3,northeastern_university,reject,15
314,161,153,0,2.83,17,3,northeastern_university,reject,15
310,158,152,96.0,2.25,33,0,northeastern_university,reject,15
316,168,148,98.0,3.04,16,2,northeastern_university,reject,15
319,169,150,101.0,3.03,8,0,northeastern_university,reject,15
320,162,158,0,2.8,31,0,northeastern_university,reject,15
309,160,149,106.0,3.15,26,0,northeastern_university,reject,15
319,166,153,97.0,3.42,21,0,northeastern_university,reject,15
315,163,152,103.0,3.24,40,3,northeastern_university,reject,15
303,158,145,94.0,2.6,35,0,northeastern_university,reject,15
318,168,150,107.0,3.27,1,0,northeastern_university,reject,15
305,155,150,114,2.98,0,0,northeastern_university,reject,15
317,168,149,102.0,2.98,3,0,northeastern_university,reject,15
325,170,155,105.0,3.3,24,0,northeastern_university,reject,15
307,160,147,75.0,3.48,11,0,northeastern_university,reject,15
314,163,151,104.0,3.31,0,1,northeastern_university,reject,15
307,161,146,112.0,3.53,36,3,northeastern_university,reject,15
315,160,155,75.0,3.33,42,0,northeastern_university,reject,15
303,154,149,104.0,3.17,5,0,northeastern_university,reject,15
314,164,150,92.0,2.6,18,0,northeastern_university,reject,15
313,165,148,0,2.58,10,2,northeastern_university,reject,15
314,164,150,105.0,3.31,1,3,northeastern_university,reject,15
310,163,147,0,3.24,14,3,northeastern_university,reject,15
315,166,149,98.0,3.36,1,3,northeastern_university,reject,15
314,163,151,114.0,2.27,18,0,northeastern_university,reject,15
312,164,148,97.0,3.65,27,3,northeastern_university,reject,15
310,160,150,97.0,3.51,41,0,northeastern_university,reject,15
306,157,149,107.0,2.61,11,0,northeastern_university,reject,15
312,147,165,106.0,2.75,15,3,northeastern_university,reject,15
312,147,165,106.0,2.75,15,3,northeastern_university,reject,15
320,164,156,0,2.55,51,0,northeastern_university,reject,15
304,156,148,104.0,2.7,25,0,northeastern_university,reject,15
316,163,153,110.0,3.56,23,0,northeastern_university,reject,15
300,156,144,93.0,3.62,24,0,northeastern_university,reject,15
321,167,154,113.0,2.1,24,0,northeastern_university,reject,15
301,153,148,95.0,1.82,12,3,northeastern_university,reject,15
313,163,150,96.0,3.44,28,0,northeastern_university,reject,15
311,161,150,111.0,2.69,24,0,northeastern_university,reject,15
303,158,145,101.0,3.62,0,3,northeastern_university,reject,15
311,161,150,101.0,3.36,0,0,northeastern_university,reject,15
306,157,149,102.0,2.1,0,3,northeastern_university,reject,15
323,156,167,107.0,3.02,36,0,northeastern_university,reject,15
308,160,148,103.0,3.42,24,0,northeastern_university,reject,15
308,160,148,103.0,3.42,24,0,northeastern_university,reject,15
311,162,149,104.0,2.45,0,0,northeastern_university,reject,15
304,160,144,99.0,3.6,0,0,northeastern_university,reject,15
315,164,151,108.0,3.17,8,0,northeastern_university,reject,15
315,161,154,112.0,2.36,12,3,northeastern_university,reject,15
314,166,148,103.0,2.85,18,3,northeastern_university,reject,15
318,167,151,104.0,3.12,13,0,northeastern_university,reject,15
308,156,152,0,2.77,28,0,northeastern_university,reject,15
306,154,152,109.0,3.41,0,0,northeastern_university,reject,15
322,167,155,107.0,2.86,27,3,northeastern_university,reject,15
319,164,155,112.0,2.6,5,0,northeastern_university,reject,15
310,158,152,96.0,2.54,1,3,northeastern_university,reject,15
304,160,144,99.0,3.1,2,0,northeastern_university,reject,15
312,160,152,0,3.06,0,3,northeastern_university,reject,15
320,167,153,0,3.04,1,2,northeastern_university,reject,15
312,163,149,107.0,3.42,30,0,northeastern_university,reject,15
312,163,149,107.0,3.42,30,0,northeastern_university,reject,15
313,161,152,0,2.53,17,0,northeastern_university,reject,15
310,159,151,103.0,3.31,15,3,northeastern_university,reject,15
314,161,153,0,2.83,17,3,northeastern_university,reject,15
305,158,147,0,2.8,3,0,northeastern_university,reject,15
316,168,148,98.0,3.04,16,2,northeastern_university,reject,15
319,169,150,101.0,3.03,8,0,northeastern_university,reject,15
320,162,158,0,2.8,31,0,northeastern_university,reject,15
308,161,147,65.0,3.23,29,0,northeastern_university,reject,15
319,166,153,97.0,3.42,21,0,northeastern_university,reject,15
315,163,152,103.0,3.24,40,3,northeastern_university,reject,15
303,158,145,94.0,2.6,35,0,northeastern_university,reject,15
302,152,150,0,3.56,2,0,northeastern_university,reject,15
305,155,150,114,2.98,0,0,northeastern_university,reject,15
317,168,149,102.0,2.98,3,0,northeastern_university,reject,15
325,170,155,105.0,3.3,24,0,northeastern_university,reject,15
319,168,151,107.0,2.0,0,0,northeastern_university,reject,15
329,167,162,106.0,2.15,36,0,northeastern_university,reject,15
311,162,149,0,2.76,29,0,northeastern_university,reject,15
308,164,144,100.0,3.28,1,3,northeastern_university,reject,15
316,160,156,102.0,2.39,1,0,northeastern_university,reject,15
310,162,148,95.0,3.12,53,0,northeastern_university,reject,15
312,157,155,98.0,2.6,27,2,northeastern_university,reject,15
310,160,150,101.0,3.26,0,0,northeastern_university,reject,15
310,165,145,65.0,2.81,16,0,northeastern_university,reject,15
319,167,152,110.0,2.4,18,0,northeastern_university,reject,15
320,164,156,112.0,2.33,15,3,northeastern_university,reject,15
304,160,144,102.0,2.71,0,0,northeastern_university,reject,15
307,158,149,106.0,3.4,4,3,northeastern_university,reject,15
312,162,150,113.0,3.74,4,3,northeastern_university,reject,15
319,167,152,100.0,3.33,51,0,northeastern_university,reject,15
323,168,155,104.0,3.48,7,3,northeastern_university,reject,15
320,168,152,106.0,2.92,17,0,northeastern_university,reject,15
312,163,149,114,3.21,3,0,northeastern_university,reject,15
310,157,153,99.0,2.55,21,0,northeastern_university,reject,15
314,158,156,111.0,3.33,23,0,northeastern_university,reject,15
316,170,146,98.0,2.8,30,0,northeastern_university,reject,15
303,153,150,75.0,2.22,36,0,northeastern_university,reject,15
312,162,150,102.0,3.2,18,0,northeastern_university,reject,15
315,166,149,108.0,3.13,15,3,northeastern_university,reject,15
304,152,152,106.0,3.26,28,0,northeastern_university,reject,15
317,160,157,0,2.85,5,0,northeastern_university,reject,15
319,161,158,111.0,2.96,6,0,northeastern_university,reject,15
311,168,143,102.0,3.44,0,0,northeastern_university,reject,15
310,166,144,114,2.42,0,0,northeastern_university,reject,15
317,162,155,0,3.2,34,0,northeastern_university,reject,15
319,164,155,114,2.37,0,0,northeastern_university,reject,15
313,163,150,75.0,3.28,20,0,northeastern_university,reject,15
317,164,153,107.0,3.36,18,0,northeastern_university,reject,15
306,164,142,107.0,3.5,4,3,northeastern_university,reject,15
316,167,149,100.0,2.9,6,0,northeastern_university,reject,15
324,167,157,109.0,3.63,20,0,northeastern_university,reject,15
323,167,156,0,3.54,6,3,northeastern_university,reject,15
306,162,144,0,3.24,8,3,northeastern_university,reject,15
302,155,147,98.0,3.2,29,1,northeastern_university,reject,15
326,165,161,118.0,2.35,0,0,northeastern_university,reject,15
304,158,146,75.0,3.0,0,0,northeastern_university,reject,15
303,160,143,98.0,2.92,30,0,northeastern_university,reject,15
309,161,148,106.0,3.09,0,0,northeastern_university,reject,15
298,157,141,90.0,2.5,28,0,northeastern_university,reject,15
299,159,140,0,2.81,1,0,northeastern_university,reject,15
317,160,157,108.0,3.36,29,0,northeastern_university,reject,15
318,167,151,101.0,2.6,36,0,northeastern_university,reject,15
306,156,150,75.0,3.38,1,0,northeastern_university,reject,15
306,156,150,75.0,3.38,1,0,northeastern_university,reject,15
309,160,149,90.0,1.81,50,0,northeastern_university,reject,15
313,163,150,96.0,3.45,0,0,northeastern_university,reject,15
312,160,152,0,2.45,13,0,northeastern_university,reject,15
317,163,154,111.0,2.82,24,3,northeastern_university,reject,15
304,160,144,87.0,2.25,40,0,northeastern_university,reject,15
322,168,154,104.0,3.36,50,0,northeastern_university,reject,15
312,161,151,97.0,3.45,0,0,northeastern_university,reject,15
308,159,149,93.0,1.96,33,3,northeastern_university,reject,15
320,163,157,101.0,2.5,27,3,northeastern_university,reject,15
310,164,146,102.0,2.62,28,0,northeastern_university,reject,15
325,165,160,114.0,2.66,33,0,northeastern_university,reject,15
330,165,165,118.0,3.56,7,0,northeastern_university,reject,15
309,159,150,104.0,3.14,17,0,northeastern_university,reject,15
305,155,150,101,2.65,24,2,northeastern_university,reject,15
291,152,139,101,2.45,7,0,northeastern_university,reject,15
291,152,139,101,2.45,7,0,northeastern_university,reject,15
312,150,162,0,3.44,0,0,northeastern_university,reject,15
310,160,150,103.0,3.42,36,0,northeastern_university,reject,15
317,167,150,99.0,3.3,30,0,northeastern_university,reject,15
315,169,146,98.0,3.15,24,0,northeastern_university,reject,15
308,160,148,98.0,2.42,6,3,northeastern_university,reject,15
322,170,152,107.0,3.56,39,0,northeastern_university,reject,15
313,163,150,0,2.94,23,3,northeastern_university,reject,15
308,163,145,0,2.87,0,0,northeastern_university,reject,15
310,161,149,90.0,2.65,48,0,northeastern_university,reject,15
304,162,142,95.0,2.4,3,3,northeastern_university,reject,15
306,158,148,0,3.84,30,0,northeastern_university,reject,15
310,163,147,101.0,3.06,14,3,northeastern_university,reject,15
316,165,151,112.0,3.09,1,1,northeastern_university,reject,15
306,159,147,96.0,2.61,44,0,northeastern_university,reject,15
309,160,149,93.0,2.85,2,3,northeastern_university,reject,15
309,160,149,93.0,2.85,2,3,northeastern_university,reject,15
320,170,150,104.0,3.42,9,0,northeastern_university,reject,15
303,162,141,101,3.27,12,0,northeastern_university,reject,15
307,164,143,101.0,3.24,34,0,northeastern_university,reject,15
305,160,145,104.0,3.31,20,0,northeastern_university,reject,15
313,162,151,97.0,3.12,28,0,northeastern_university,reject,15
324,165,159,110.0,2.6,12,0,northeastern_university,reject,15
307,160,147,111.0,2.8,0,0,northeastern_university,reject,15
307,156,151,102.0,2.8,0,0,northeastern_university,reject,15
324,169,155,112.0,3.1,14,0,northeastern_university,reject,15
312,167,145,0,3.12,33,0,northeastern_university,reject,15
312,162,150,0,3.45,1,3,northeastern_university,reject,15
306,161,145,75.0,2.89,18,3,northeastern_university,reject,15
327,168,159,115.0,2.8,15,0,northeastern_university,reject,15
319,167,152,107.0,3.44,0,0,northeastern_university,reject,15
326,167,159,0,2.0,36,0,northeastern_university,reject,15
311,160,151,108.0,3.18,50,0,northeastern_university,reject,15
316,163,153,104.0,3.04,21,0,northeastern_university,reject,15
304,159,145,96.0,2.52,20,0,northeastern_university,reject,15
318,165,153,116.0,2.23,25,0,northeastern_university,reject,15
312,161,151,109.0,3.21,18,0,northeastern_university,reject,15
317,165,152,105.0,3.08,1,0,northeastern_university,reject,15
319,164,155,109.0,2.88,4,0,northeastern_university,reject,15
322,167,155,101.0,2.69,26,3,northeastern_university,reject,15
308,160,148,101,2.85,0,3,northeastern_university,reject,15
311,156,155,98.0,2.76,12,0,northeastern_university,reject,15
313,167,146,93.0,3.52,30,0,northeastern_university,reject,15
316,166,150,99.0,2.4,0,0,northeastern_university,reject,15
311,162,149,96.0,3.33,2,1,northeastern_university,reject,15
307,157,150,0,3.23,8,0,northeastern_university,reject,15
322,169,153,111.0,3.15,41,0,northeastern_university,reject,15
313,161,152,106.0,3.1,0,3,northeastern_university,reject,15
323,166,157,0,3.23,25,3,northeastern_university,reject,15
318,162,156,0,3.8,0,0,northeastern_university,reject,15
304,160,144,100.0,3.12,1,0,northeastern_university,reject,15
316,163,153,96.0,2.86,4,0,northeastern_university,reject,15
315,168,147,104.0,2.96,15,3,northeastern_university,reject,15
317,159,158,99.0,3.31,38,0,northeastern_university,reject,15
307,161,146,101.0,3.32,20,0,northeastern_university,reject,15
318,158,160,111.0,2.05,12,3,northeastern_university,reject,15
307,161,146,101,3.17,2,3,northeastern_university,reject,15
312,167,145,101,3.42,0,0,northeastern_university,reject,15
313,162,151,98.0,3.16,15,3,northeastern_university,reject,15
314,162,152,91.0,2.82,15,0,northeastern_university,reject,15
300,155,145,103.0,3.1,2,0,northeastern_university,reject,15
313,170,143,65.0,2.63,9,0,northeastern_university,reject,15
314,162,152,111.0,3.11,1,0,northeastern_university,reject,15
305,155,150,101.0,3.36,24,3,northeastern_university,reject,15
307,159,148,93.0,2.98,15,3,northeastern_university,reject,15
311,162,149,105.0,2.45,0,0,northeastern_university,reject,15
311,162,149,105.0,2.45,0,0,northeastern_university,reject,15
326,170,156,111.0,3.47,20,0,northeastern_university,reject,15
325,166,159,111.0,2.7,30,0,northeastern_university,reject,15
319,162,157,104.0,3.3,18,0,northeastern_university,reject,15
307,158,149,107.0,2.92,12,0,northeastern_university,reject,15
309,158,151,109.0,3.08,23,3,northeastern_university,reject,15
312,167,145,85.0,3.3,30,0,northeastern_university,reject,15
309,159,150,99.0,3.2,42,0,northeastern_university,reject,15
308,159,149,101,2.69,0,0,northeastern_university,reject,15
320,169,151,106.0,3.01,25,0,northeastern_university,reject,15
323,165,158,109.0,2.88,2,0,northeastern_university,reject,15
307,166,141,101,3.62,22,3,northeastern_university,reject,15
312,163,149,103.0,3.4,13,0,northeastern_university,reject,15
306,161,145,100.0,3.26,0,3,northeastern_university,reject,15
318,167,151,103.0,2.84,10,3,northeastern_university,reject,15
310,160,150,0,3.51,4,0,northeastern_university,reject,15
312,161,151,104.0,2.5,2,1,northeastern_university,reject,15
306,157,149,95.0,3.12,42,0,northeastern_university,reject,15
309,163,146,100.0,3.5,15,0,northeastern_university,reject,15
307,160,147,101.0,3.48,19,0,northeastern_university,reject,15
311,162,149,0,2.25,29,0,northeastern_university,reject,15
307,164,143,93.0,3.21,22,3,northeastern_university,reject,15
316,162,154,96.0,2.82,24,0,northeastern_university,reject,15
307,158,149,105.0,2.72,10,3,northeastern_university,reject,15
324,169,155,112.0,3.16,15,3,northeastern_university,reject,15
308,163,145,83.0,3.36,2,0,northeastern_university,reject,15
307,159,148,75.0,3.44,0,3,northeastern_university,reject,15
307,161,146,101.0,2.1,33,0,northeastern_university,reject,15
310,155,155,111.0,2.96,15,0,northeastern_university,reject,15
310,155,155,111.0,2.96,15,0,northeastern_university,reject,15
318,160,158,0,2.91,0,0,northeastern_university,reject,15
319,160,159,111.0,3.14,10,3,northeastern_university,reject,15
317,169,148,95.0,3.24,0,0,northeastern_university,reject,15
311,167,144,101.0,3.21,10,0,northeastern_university,reject,15
316,163,153,0,3.73,1,0,northeastern_university,reject,15
322,167,155,113.0,3.56,0,0,northeastern_university,reject,15
314,165,149,108.0,2.08,0,1,northeastern_university,reject,15
306,163,143,92.0,2.99,7,1,northeastern_university,reject,15
311,163,148,101.0,3.56,22,0,northeastern_university,reject,15
321,167,154,112.0,3.44,37,0,northeastern_university,reject,15
323,167,156,110.0,3.0,29,0,northeastern_university,reject,15
322,166,156,108.0,3.28,45,0,northeastern_university,reject,15
325,170,155,106.0,2.59,31,0,northeastern_university,reject,15
316,162,154,117.0,3.64,4,1,northeastern_university,reject,15
314,168,146,0,3.23,0,0,northeastern_university,reject,15
307,160,147,75.0,3.48,11,0,northeastern_university,reject,15
315,166,149,0,3.08,4,0,northeastern_university,reject,15
320,164,156,114.0,2.54,29,0,northeastern_university,reject,15
311,164,147,105.0,3.2,15,3,northeastern_university,reject,15
313,160,153,107.0,2.4,11,0,northeastern_university,reject,15
315,166,149,98.0,3.26,26,0,northeastern_university,reject,15
303,152,151,94.0,2.99,38,0,northeastern_university,reject,15
308,162,146,0,2.57,6,0,northeastern_university,reject,15
308,162,146,0,2.57,6,0,northeastern_university,reject,15
300,156,144,95.0,2.9,16,3,northeastern_university,reject,15
308,163,145,87.0,2.67,48,1,northeastern_university,reject,15
313,165,148,96.0,3.57,6,0,northeastern_university,reject,15
321,167,154,114.0,3.08,0,3,northeastern_university,reject,15
315,167,148,0,2.94,0,3,northeastern_university,reject,15
324,170,154,106.0,3.48,27,0,northeastern_university,reject,15
308,158,150,100.0,2.65,0,0,northeastern_university,reject,15
314,162,152,112.0,2.07,11,3,northeastern_university,reject,15
318,166,152,102.0,2.77,8,3,northeastern_university,reject,15
308,161,147,0,1.94,36,3,northeastern_university,reject,15
312,161,151,0,3.14,2,0,northeastern_university,reject,15
315,163,152,92.0,3.04,26,0,northeastern_university,reject,15
318,160,158,109.0,2.87,41,0,northeastern_university,reject,15
324,167,157,112.0,2.65,6,3,northeastern_university,reject,15
312,166,146,86.0,3.0,38,0,northeastern_university,reject,15
312,166,146,86.0,3.0,38,0,northeastern_university,reject,15
312,148,164,90.0,3.39,33,0,northeastern_university,reject,15
322,152,170,101.0,2.72,0,0,northeastern_university,reject,15
309,164,145,94.0,2.92,2,0,northeastern_university,reject,15
300,155,145,93.0,3.12,13,0,northeastern_university,reject,15
310,162,148,95.0,3.2,0,3,northeastern_university,reject,15
301,155,146,102.0,2.8,1,0,northeastern_university,reject,15
311,160,151,94.0,2.72,52,0,northeastern_university,reject,15
308,158,150,105.0,3.21,0,0,northeastern_university,reject,15
328,168,160,0,2.72,19,3,northeastern_university,reject,15
316,164,152,101.0,1.95,14,2,northeastern_university,reject,15
313,159,154,104.0,2.88,19,0,northeastern_university,reject,15
312,157,155,108.0,2.84,24,3,northeastern_university,reject,15
315,161,154,101.0,3.31,12,0,northeastern_university,reject,15
331,170,161,111.0,2.4,0,0,northeastern_university,reject,15
320,162,158,0,3.14,19,3,northeastern_university,reject,15
313,164,149,101.0,2.96,33,3,northeastern_university,reject,15
313,164,149,101.0,2.96,33,3,northeastern_university,reject,15
321,170,151,103.0,3.12,22,3,northeastern_university,reject,15
318,165,153,107.0,2.4,30,2,northeastern_university,reject,15
321,167,154,113.0,2.15,28,0,northeastern_university,reject,15
320,165,155,108.0,3.4,18,0,northeastern_university,reject,15
304,163,141,98.0,3.31,0,0,northeastern_university,reject,15
309,164,145,92.0,3.22,0,0,northeastern_university,reject,15
319,165,154,97.0,3.3,18,0,northeastern_university,reject,15
323,168,155,104.0,3.64,20,3,northeastern_university,reject,15
322,167,155,117.0,3.53,2,3,northeastern_university,reject,15
320,170,150,104.0,2.25,35,0,northeastern_university,reject,15
315,165,150,103.0,3.75,4,1,northeastern_university,reject,15
311,167,144,99.0,3.18,7,0,northeastern_university,reject,15
308,157,151,96.0,3.01,15,0,northeastern_university,reject,15
328,163,165,0,2.25,0,0,northeastern_university,reject,15
313,156,157,105.0,3.23,17,3,northeastern_university,reject,15
321,170,151,75.0,3.32,0,0,northeastern_university,reject,15
311,165,146,104.0,2.82,0,0,northeastern_university,reject,15
308,160,148,106.0,2.5,0,0,northeastern_university,reject,15
325,167,158,113.0,3.44,14,0,northeastern_university,reject,15
309,163,146,94.0,3.65,2,0,northeastern_university,reject,15
315,164,151,105.0,3.32,27,0,northeastern_university,reject,15
303,161,142,99.0,3.53,0,3,northeastern_university,reject,15
314,166,148,104.0,3.63,5,0,northeastern_university,reject,15
308,166,142,0,3.37,0,0,northeastern_university,reject,15
310,159,151,103.0,3.18,39,0,northeastern_university,reject,15
311,160,151,111.0,2.49,26,2,northeastern_university,reject,15
318,160,158,110.0,2.14,21,0,northeastern_university,reject,15
320,163,157,102.0,2.75,31,0,northeastern_university,reject,15
316,164,152,91.0,2.6,0,0,northeastern_university,reject,15
317,151,166,108.0,3.2,2,0,northeastern_university,reject,15
317,165,152,95.0,2.44,18,2,northeastern_university,reject,15
310,162,148,106.0,3.44,12,3,northeastern_university,reject,15
308,158,150,91.0,2.18,0,0,northeastern_university,reject,15
315,159,156,114.0,3.14,0,0,northeastern_university,reject,15
320,168,152,0,2.99,27,0,northeastern_university,reject,15
313,163,150,107.0,2.96,13,3,northeastern_university,reject,15
322,166,156,103.0,2.25,8,3,northeastern_university,reject,15
312,160,152,106.0,2.92,0,0,northeastern_university,reject,15
316,163,153,0,2.68,15,3,northeastern_university,reject,15
320,165,155,101.0,2.51,1,0,northeastern_university,reject,15
317,162,155,0,3.56,16,0,northeastern_university,reject,15
315,165,150,102.0,2.45,0,0,northeastern_university,reject,15
320,164,156,0,3.36,30,0,northeastern_university,reject,15
318,161,157,0,2.95,13,0,northeastern_university,reject,15
308,161,147,107.0,3.49,57,2,northeastern_university,reject,15
314,162,152,108.0,2.95,20,0,northeastern_university,reject,15
314,162,152,108.0,2.95,20,0,northeastern_university,reject,15
310,164,146,106.0,2.07,13,3,northeastern_university,reject,15
306,160,146,0,3.1,18,0,northeastern_university,reject,15
315,161,154,0,2.84,1,0,northeastern_university,reject,15
313,156,157,114,2.25,1,0,northeastern_university,reject,15
314,166,148,98.0,3.26,16,0,northeastern_university,reject,15
319,165,154,106.0,3.59,2,0,northeastern_university,reject,15
307,157,150,105.0,2.22,26,0,northeastern_university,reject,15
310,161,149,112.0,3.4,25,0,northeastern_university,reject,15
327,170,157,112.0,3.08,32,3,northeastern_university,reject,15
314,167,147,90.0,2.3,56,0,northeastern_university,reject,15
305,161,144,88.0,2.9,36,0,northeastern_university,reject,15
314,162,152,101.0,2.85,6,0,northeastern_university,reject,15
309,159,150,105.0,3.32,30,3,northeastern_university,reject,15
311,161,150,110.0,3.28,20,1,northeastern_university,reject,15
328,170,158,108.0,3.21,0,0,northeastern_university,reject,15
323,170,153,102.0,3.6,4,0,northeastern_university,reject,15
323,170,153,102.0,3.6,4,0,northeastern_university,reject,15
304,160,144,91.0,3.2,57,0,northeastern_university,reject,15
317,162,155,101.0,3.49,24,0,northeastern_university,reject,15
311,162,149,107.0,3.13,3,3,northeastern_university,reject,15
320,170,150,111.0,3.26,22,0,northeastern_university,reject,15
309,159,150,114,2.3,20,0,northeastern_university,reject,15
303,161,142,87.0,3.47,20,0,northeastern_university,reject,15
305,155,150,98.0,3.44,12,0,northeastern_university,reject,15
304,161,143,94.0,2.3,35,0,northeastern_university,reject,15
319,170,149,0,3.32,0,3,northeastern_university,reject,15
311,165,146,75.0,2.78,15,3,northeastern_university,reject,15
308,158,150,100.0,2.97,25,0,northeastern_university,reject,15
326,168,158,0,3.22,1,3,northeastern_university,reject,15
303,160,143,95.0,3.0,0,0,northeastern_university,reject,15
311,158,153,114.0,3.61,5,0,northeastern_university,reject,15
311,158,153,116.0,2.37,43,0,northeastern_university,reject,15
314,162,152,89.0,3.12,0,0,northeastern_university,reject,15
314,162,152,89.0,3.12,0,0,northeastern_university,reject,15
311,163,148,93.0,1.13,0,0,northeastern_university,reject,15
306,162,144,107.0,3.24,0,0,northeastern_university,reject,15
304,156,148,99.0,2.9,23,0,northeastern_university,reject,15
302,160,142,92.0,2.81,16,0,northeastern_university,reject,15
315,165,150,103.0,2.55,42,0,northeastern_university,reject,15
311,151,160,94.0,3.25,35,0,northeastern_university,reject,15
300,158,142,95.0,3.02,27,0,northeastern_university,reject,15
309,159,150,108.0,2.7,12,2,northeastern_university,reject,15
310,161,149,91.0,2.6,29,0,northeastern_university,reject,15
313,162,151,102.0,2.9,33,0,northeastern_university,reject,15
314,165,149,102.0,2.43,7,1,northeastern_university,reject,15
301,156,145,89.0,2.95,2,0,northeastern_university,reject,15
307,160,147,93.0,2.84,0,0,northeastern_university,reject,15
313,155,158,106.0,2.23,0,0,northeastern_university,reject,15
303,154,149,105.0,1.77,0,0,northeastern_university,reject,15
313,157,156,89.0,2.12,0,0,northeastern_university,reject,15
310,163,147,95.0,3.25,4,0,northeastern_university,reject,15
314,164,150,101,1.8,1,0,northeastern_university,reject,15
308,160,148,100.0,2.31,0,0,northeastern_university,reject,15
302,154,148,101,3.32,0,0,northeastern_university,reject,15
298,152,146,99.0,2.0,36,0,northeastern_university,reject,15
317,160,157,109.0,2.63,0,0,northeastern_university,reject,15
312,162,150,103.0,2.68,0,0,northeastern_university,reject,15
329,167,162,118.0,3.12,2,0,northeastern_university,reject,15
323,167,156,95.0,2.59,0,3,northeastern_university,reject,15
316,164,152,108.0,2.02,0,3,northeastern_university,reject,15
304,157,147,93.0,2.46,3,0,northeastern_university,reject,15
305,155,150,96.0,3.09,20,0,northeastern_university,reject,15
316,162,154,115.0,3.72,6,3,northeastern_university,reject,15
321,167,154,112.0,2.4,18,0,northeastern_university,reject,15
304,164,140,75.0,2.6,54,0,northeastern_university,reject,15
323,162,161,113.0,2.15,11,0,northeastern_university,reject,15
308,156,152,92.0,3.13,19,0,northeastern_university,reject,15
308,156,152,92.0,3.13,19,0,northeastern_university,reject,15
322,168,154,114.0,2.1,40,0,northeastern_university,reject,15
307,160,147,102.0,2.5,30,0,northeastern_university,reject,15
313,163,150,104.0,2.15,74,0,northeastern_university,reject,15
312,162,150,107.0,2.88,20,0,northeastern_university,reject,15
308,157,151,113.0,2.25,29,0,northeastern_university,reject,15
311,158,153,102.0,2.15,14,3,northeastern_university,reject,15
311,160,151,96.0,3.08,2,0,northeastern_university,reject,15
320,166,154,108.0,3.11,20,0,northeastern_university,reject,15
309,161,148,98.0,1.06,2,0,northeastern_university,reject,15
308,159,149,82.0,3.64,0,0,northeastern_university,reject,15
310,162,148,94.0,3.05,37,0,northeastern_university,reject,15
308,158,150,94.0,3.4,12,0,northeastern_university,reject,15
315,165,150,96.0,3.05,9,0,northeastern_university,reject,15
309,162,147,94.0,3.01,18,0,northeastern_university,reject,15
309,162,147,94.0,3.01,18,0,northeastern_university,reject,15
307,158,149,107.0,2.28,40,0,northeastern_university,reject,15
305,160,145,89.0,2.37,21,3,northeastern_university,reject,15
307,155,152,97.0,2.4,17,3,northeastern_university,reject,15
318,161,157,103.0,2.39,36,0,northeastern_university,reject,15
303,162,141,91.0,3.07,17,0,northeastern_university,reject,15
309,155,154,95.0,2.35,18,0,northeastern_university,reject,15
310,157,153,110.0,2.35,38,0,northeastern_university,reject,15
311,153,158,108.0,2.15,36,3,northeastern_university,reject,15
305,160,145,90.0,3.23,30,0,northeastern_university,reject,15
305,156,149,102.0,3.35,0,0,northeastern_university,reject,15
319,167,152,93.0,3.44,3,0,northeastern_university,reject,15
313,166,147,0,1.99,29,0,northeastern_university,reject,15
301,157,144,93.0,2.6,5,0,northeastern_university,reject,15
310,163,147,75.0,3.18,0,0,northeastern_university,reject,15
294,153,141,83.0,2.18,78,0,northeastern_university,reject,15
294,153,141,83.0,2.18,78,0,northeastern_university,reject,15
315,167,148,93.0,3.0,2,0,northeastern_university,reject,15
308,161,147,104.0,2.1,3,0,northeastern_university,reject,15
315,163,152,103.0,2.85,44,0,northeastern_university,reject,15
315,162,153,106.0,2.3,60,0,northeastern_university,reject,15
314,165,149,110.0,3.24,0,0,northeastern_university,reject,15
318,167,151,100.0,3.47,1,0,northeastern_university,reject,15
300,156,144,102.0,2.15,20,0,northeastern_university,reject,15
310,161,149,95.0,3.41,19,0,northeastern_university,reject,15
309,160,149,105.0,2.62,15,1,northeastern_university,reject,15
302,153,149,89.0,3.32,24,0,northeastern_university,reject,15
307,162,145,93.0,2.54,16,0,northeastern_university,reject,15
328,165,163,110.0,2.6,60,0,northeastern_university,reject,15
316,167,149,89.0,2.75,19,0,northeastern_university,reject,15
307,161,146,91.0,3.39,18,0,northeastern_university,reject,15
311,165,146,96.0,2.5,5,0,northeastern_university,reject,15
311,165,146,96.0,2.5,5,0,northeastern_university,reject,15
312,161,151,95.0,3.04,0,0,northeastern_university,reject,15
317,165,152,111.0,3.25,6,0,northeastern_university,reject,15
294,157,137,87.0,2.75,60,0,northeastern_university,reject,15
317,163,154,112.0,3.6,21,2,northeastern_university,reject,15
311,162,149,92.0,3.14,0,0,northeastern_university,reject,15
308,163,145,90.0,2.27,0,1,northeastern_university,reject,15
311,162,149,112.0,3.16,1,0,northeastern_university,reject,15
303,158,145,91.0,2.5,4,2,northeastern_university,reject,15
320,170,150,103.0,3.06,32,0,northeastern_university,reject,15
320,167,153,103.0,3.28,18,0,northeastern_university,reject,15
298,161,137,90.0,2.85,21,0,northeastern_university,reject,15
307,163,144,94.0,2.2,0,2,northeastern_university,reject,15
313,164,149,108.0,2.16,32,3,northeastern_university,reject,15
305,161,144,89.0,2.36,55,0,northeastern_university,reject,15
323,166,157,112.0,2.5,5,3,northeastern_university,reject,15
311,168,143,91.0,3.56,8,3,northeastern_university,reject,15
303,159,144,88.0,2.87,36,0,northeastern_university,reject,15
321,170,151,105.0,3.47,7,3,northeastern_university,reject,15
311,160,151,105.0,2.1,32,2,northeastern_university,reject,15
305,158,147,105.0,2.89,2,0,northeastern_university,reject,15
314,165,149,93.0,2.76,42,0,northeastern_university,reject,15
314,165,149,94.0,2.73,45,0,northeastern_university,reject,15
307,158,149,97.0,3.34,0,0,northeastern_university,reject,15
310,159,151,107.0,3.55,44,0,northeastern_university,reject,15
308,164,144,94.0,2.52,36,3,northeastern_university,reject,15
299,156,143,100.0,2.4,29,0,northeastern_university,reject,15
308,160,148,100.0,1.8,0,2,northeastern_university,reject,15
313,159,154,113.0,3.46,24,0,northeastern_university,reject,15
319,170,149,93.0,2.4,8,3,northeastern_university,reject,15
328,167,161,113.0,2.37,35,2,northeastern_university,reject,15
313,163,150,99.0,2.82,25,0,northeastern_university,reject,15
316,164,152,97.0,2.92,9,0,northeastern_university,reject,15
310,158,152,109.0,2.3,21,3,northeastern_university,reject,15
308,159,149,104.0,3.45,3,3,northeastern_university,reject,15
323,164,159,109.0,3.41,1,0,northeastern_university,reject,15
316,170,146,104.0,3.6,18,3,northeastern_university,reject,15
309,163,146,90.0,3.26,6,0,northeastern_university,reject,15
311,161,150,92.0,2.92,44,0,northeastern_university,reject,15
321,167,154,112.0,3.02,30,0,northeastern_university,reject,15
306,161,145,98.0,2.21,36,0,northeastern_university,reject,15
317,162,155,102.0,1.85,14,2,northeastern_university,reject,15
330,167,163,115.0,2.1,19,0,northeastern_university,reject,15
301,159,142,84.0,2.4,36,0,northeastern_university,reject,15
304,156,148,107.0,2.65,28,0,northeastern_university,reject,15
308,162,146,89.0,3.12,21,0,northeastern_university,reject,15
308,161,147,90.0,3.36,54,0,northeastern_university,reject,15
305,158,147,91.0,1.92,26,3,northeastern_university,reject,15
308,159,149,104.0,2.64,14,2,northeastern_university,reject,15
316,163,153,98.0,2.18,51,0,northeastern_university,reject,15
316,163,153,98.0,2.18,51,0,northeastern_university,reject,15
312,164,148,89.0,3.43,32,3,northeastern_university,reject,15
309,166,143,95.0,1.34,33,0,northeastern_university,reject,15
324,170,154,103.0,3.54,2,3,northeastern_university,reject,15
320,170,150,101.0,2.74,46,3,northeastern_university,reject,15
310,163,147,95.0,3.27,4,0,northeastern_university,reject,15
318,165,153,104.0,3.42,14,2,northeastern_university,reject,15
330,170,160,113.0,3.4,36,0,northeastern_university,reject,15
317,162,155,104.0,2.17,77,0,northeastern_university,reject,15
310,162,148,97.0,3.2,0,0,northeastern_university,reject,15
300,158,142,96.0,3.58,69,0,northeastern_university,reject,15
312,160,152,86.0,2.5,12,3,northeastern_university,reject,15
322,165,157,109.0,2.45,16,1,northeastern_university,reject,15
302,158,144,91.0,2.08,21,3,northeastern_university,reject,15
317,164,153,102.0,2.15,0,0,northeastern_university,reject,15
309,161,148,89.0,2.59,31,0,northeastern_university,reject,15
313,168,145,95.0,1.9,7,1,northeastern_university,reject,15
313,168,145,95.0,1.9,7,1,northeastern_university,reject,15
309,161,148,106.0,2.1,53,0,northeastern_university,reject,15
304,161,143,104.0,2.34,19,0,northeastern_university,reject,15
317,166,151,93.0,2.0,0,0,northeastern_university,reject,15
307,158,149,93.0,1.9,60,0,northeastern_university,reject,15
321,161,160,114.0,2.72,0,0,northeastern_university,reject,15
319,167,152,99.0,3.0,6,3,northeastern_university,reject,15
322,168,154,102.0,2.5,2,0,northeastern_university,reject,15
311,163,148,95.0,3.28,0,0,northeastern_university,reject,15
315,167,148,99.0,2.82,8,3,northeastern_university,reject,15
315,160,155,114.0,2.28,12,0,northeastern_university,reject,15
316,170,146,100.0,3.2,25,0,northeastern_university,reject,15
310,164,146,97.0,3.11,24,0,northeastern_university,reject,15
303,162,141,87.0,3.41,36,0,northeastern_university,reject,15
303,155,148,93.0,3.31,21,0,northeastern_university,reject,15
308,164,144,96.0,3.2,0,3,northeastern_university,reject,15
309,158,151,103.0,3.08,44,1,northeastern_university,reject,15
309,158,151,103.0,3.08,44,1,northeastern_university,reject,15
309,166,143,95.0,3.04,1,0,northeastern_university,reject,15
315,166,149,75.0,3.45,47,0,northeastern_university,reject,15
309,161,148,95.0,2.75,24,3,northeastern_university,reject,15
309,161,148,96.0,2.78,20,3,northeastern_university,reject,15
316,163,153,109.0,3.66,4,0,northeastern_university,reject,15
323,169,154,105.0,3.13,24,0,northeastern_university,reject,15
322,163,159,109.0,2.46,7,0,northeastern_university,reject,15
304,162,142,97.0,3.36,15,3,northeastern_university,reject,15
315,165,150,91.0,2.81,0,0,northeastern_university,reject,15
318,166,152,100.0,2.36,19,3,northeastern_university,reject,15
314,166,148,101.0,2.28,31,0,northeastern_university,reject,15
307,162,145,92.0,3.74,30,0,northeastern_university,reject,15
306,161,145,105.0,3.36,34,3,northeastern_university,reject,15
307,163,144,107.0,3.08,30,2,northeastern_university,reject,15
322,161,161,107.0,3.4,0,0,northeastern_university,reject,15
316,165,151,99.0,3.03,16,0,northeastern_university,reject,15
329,168,161,111.0,1.95,1,0,northeastern_university,reject,15
305,159,146,93.0,2.1,78,0,northeastern_university,reject,15
305,159,146,97.0,2.02,27,3,northeastern_university,reject,15
321,166,155,105.0,2.91,5,0,northeastern_university,reject,15
306,157,149,91.0,2.17,25,0,northeastern_university,reject,15
304,149,155,88.0,2.36,46,0,northeastern_university,reject,15
300,144,156,92.0,2.98,2,3,northeastern_university,reject,15
330,170,160,111.0,2.6,8,0,northeastern_university,reject,15
301,159,142,90.0,2.19,12,3,northeastern_university,reject,15
310,161,149,93.0,3.14,0,0,northeastern_university,reject,15
308,159,149,97.0,2.47,32,0,northeastern_university,reject,15
322,168,154,101,3.22,15,0,northeastern_university,reject,15
316,164,152,111.0,3.36,0,0,northeastern_university,reject,15
327,168,159,114.0,3.51,2,3,northeastern_university,reject,15
315,167,148,103.0,2.55,0,3,northeastern_university,reject,15
310,168,142,101.0,2.76,42,3,northeastern_university,reject,15
312,161,151,109.0,2.11,0,3,northeastern_university,reject,15
321,167,154,105.0,2.3,46,0,northeastern_university,reject,15
309,161,148,102.0,2.9,30,0,northeastern_university,reject,15
315,168,147,101.0,3.1,0,0,northeastern_university,reject,15
316,170,146,98.0,3.36,1,2,northeastern_university,reject,15
310,162,148,91.0,3.05,25,0,northeastern_university,reject,15
314,166,148,110.0,3.3,8,3,northeastern_university,reject,15
318,160,158,106.0,2.59,50,3,northeastern_university,reject,15
315,167,148,103.0,3.25,30,0,northeastern_university,reject,15
318,167,151,110.0,2.62,0,0,northeastern_university,reject,15
310,164,146,107.0,3.32,13,1,northeastern_university,reject,15
330,167,163,114.0,2.88,28,0,northeastern_university,reject,15
310,160,150,108.0,2.15,15,3,northeastern_university,reject,15
308,164,144,103.0,3.63,2,3,northeastern_university,reject,15
309,157,152,98.0,3.21,3,3,northeastern_university,reject,15
309,157,152,98.0,3.21,3,3,northeastern_university,reject,15
321,161,160,111.0,2.55,32,0,northeastern_university,reject,15
308,160,148,65.0,3.24,19,0,northeastern_university,reject,15
318,167,151,101.0,3.6,14,0,northeastern_university,reject,15
320,169,151,114.0,3.53,12,3,northeastern_university,reject,15
317,165,152,109.0,2.8,23,0,northeastern_university,reject,15
305,158,147,106.0,2.51,48,0,northeastern_university,reject,15
315,161,154,107.0,2.2,24,0,northeastern_university,reject,15
312,163,149,105.0,2.96,2,0,northeastern_university,reject,15
314,166,148,93.0,3.32,0,0,northeastern_university,reject,15
319,164,155,106.0,3.52,1,3,northeastern_university,reject,15
323,154,169,103.0,3.14,3,0,northeastern_university,reject,15
313,161,152,96.0,2.25,10,0,northeastern_university,reject,15
315,164,151,103.0,2.0,30,3,northeastern_university,reject,15
304,156,148,105.0,2.27,132,0,northeastern_university,reject,15
319,166,153,105.0,2.72,24,0,northeastern_university,reject,15
307,161,146,104.0,3.33,24,0,northeastern_university,reject,15
307,161,146,104.0,3.33,24,0,northeastern_university,reject,15
315,161,154,104.0,3.42,2,0,northeastern_university,reject,15
332,170,162,115.0,2.62,4,3,northeastern_university,reject,15
309,160,149,99.0,2.61,1,0,northeastern_university,reject,15
311,164,147,99.0,3.16,30,0,northeastern_university,reject,15
307,158,149,96.0,2.65,0,0,northeastern_university,reject,15
323,164,159,109.0,2.79,5,0,northeastern_university,reject,15
312,163,149,105.0,2.95,29,0,northeastern_university,reject,15
324,170,154,110.0,3.43,2,0,northeastern_university,reject,15
319,163,156,105.0,2.8,0,0,northeastern_university,reject,15
318,164,154,94.0,1.85,33,3,northeastern_university,reject,15
311,163,148,101.0,3.56,0,0,northeastern_university,reject,15
311,161,150,99.0,3.43,1,0,northeastern_university,reject,15
322,168,154,109.0,3.43,36,3,northeastern_university,reject,15
317,165,152,109.0,2.67,33,0,northeastern_university,reject,15
313,167,146,97.0,2.58,18,0,northeastern_university,reject,15
318,168,150,104.0,2.64,22,0,northeastern_university,reject,15
318,168,150,104.0,2.64,22,0,northeastern_university,reject,15
320,166,154,109.0,3.14,40,0,northeastern_university,reject,15
319,167,152,0,2.7,0,0,northeastern_university,reject,15
307,158,149,98.0,1.95,44,2,northeastern_university,reject,15
311,161,150,92.0,2.75,18,0,northeastern_university,reject,15
306,157,149,89.0,3.6,21,0,northeastern_university,reject,15
323,165,158,112.0,2.2,40,0,northeastern_university,reject,15
323,169,154,94.0,3.51,31,0,northeastern_university,reject,15
306,158,148,100.0,2.65,18,0,northeastern_university,reject,15
305,156,149,91.0,3.19,18,3,northeastern_university,reject,15
310,163,147,101.0,3.08,0,0,northeastern_university,reject,15
304,161,143,90.0,3.58,0,0,northeastern_university,reject,15
313,168,145,94.0,3.19,3,0,northeastern_university,reject,15
310,164,146,102.0,3.28,34,0,northeastern_university,reject,15
318,167,151,102.0,2.27,40,0,northeastern_university,reject,15
310,160,150,95.0,2.91,42,0,northeastern_university,reject,15
302,160,142,75.0,2.25,3,0,northeastern_university,reject,15
326,167,159,114.0,3.07,0,0,northeastern_university,reject,15
314,162,152,100.0,3.42,2,3,northeastern_university,reject,15
323,170,153,103.0,3.16,26,0,northeastern_university,reject,15
323,170,153,109.0,3.37,16,0,northeastern_university,reject,15
310,162,148,102.0,2.45,18,0,northeastern_university,reject,15
331,164,167,114.0,2.75,19,0,northeastern_university,reject,15
326,167,159,117.0,2.6,0,3,northeastern_university,reject,15
326,167,159,109.0,3.4,0,2,northeastern_university,reject,15
306,158,148,99.0,2.35,15,1,northeastern_university,reject,15
318,164,154,113.0,2.4,30,3,northeastern_university,reject,15
320,167,153,106.0,3.47,8,3,northeastern_university,reject,15
309,165,144,97.0,2.99,22,0,northeastern_university,reject,15
310,160,150,95.0,2.54,30,0,northeastern_university,reject,15
308,159,149,92.0,3.6,1,0,northeastern_university,reject,15
306,161,145,96.0,2.75,36,0,northeastern_university,reject,15
303,160,143,89.0,3.32,24,0,northeastern_university,reject,15
314,159,155,75.0,2.85,23,0,northeastern_university,reject,15
318,168,150,106.0,1.88,18,3,northeastern_university,reject,15
309,161,148,91.0,3.62,20,0,northeastern_university,reject,15
312,163,149,100.0,3.73,16,1,northeastern_university,reject,15
313,161,152,96.0,3.04,0,0,northeastern_university,reject,15
310,163,147,104.0,2.76,2,0,northeastern_university,reject,15
322,170,152,100.0,2.77,0,0,northeastern_university,reject,15
318,165,153,109.0,2.05,55,0,northeastern_university,reject,15
311,167,144,113.0,3.11,0,0,northeastern_university,reject,15
324,167,157,112.0,2.96,39,0,northeastern_university,reject,15
319,167,152,110.0,3.8,16,3,northeastern_university,reject,15
327,170,157,115.0,3.04,12,0,northeastern_university,reject,15
309,162,147,96.0,2.65,41,0,northeastern_university,reject,15
323,161,162,107.0,3.33,22,2,northeastern_university,reject,15
305,158,147,97.0,3.47,3,3,northeastern_university,reject,15
310,160,150,110.0,2.36,18,0,northeastern_university,reject,15
310,160,150,110.0,2.36,18,0,northeastern_university,reject,15
317,165,152,104.0,2.02,17,0,northeastern_university,reject,15
314,160,154,107.0,2.11,15,3,northeastern_university,reject,15
312,162,150,98.0,2.06,19,3,northeastern_university,reject,15
316,166,150,100.0,2.26,7,3,northeastern_university,reject,15
317,161,156,108.0,1.9,14,0,northeastern_university,reject,15
318,168,150,102.0,2.05,42,0,northeastern_university,reject,15
318,163,155,107.0,2.58,36,0,northeastern_university,reject,15
303,163,140,85.0,3.41,6,0,northeastern_university,reject,15
290,149,141,84.0,2.7,48,0,northeastern_university,reject,15
301,159,142,78,3.0,32,0,northeastern_university,reject,15
302,154,148,100.0,3.25,24,0,northeastern_university,reject,15
329,169,160,112.0,1.96,36,0,northeastern_university,reject,15
306,163,143,93.0,3.13,42,0,northeastern_university,reject,15
309,163,146,90.0,3.16,6,0,northeastern_university,reject,15
305,161,144,89.0,3.09,12,0,northeastern_university,reject,15
316,167,149,98.0,3.17,24,0,northeastern_university,reject,15
316,167,149,98.0,3.17,24,0,northeastern_university,reject,15
307,157,150,96.0,3.19,43,0,northeastern_university,reject,15
311,163,148,85.0,3.05,24,0,northeastern_university,reject,15
309,161,148,109.0,3.25,4,0,northeastern_university,reject,15
308,157,151,104.0,3.2,20,0,northeastern_university,reject,15
311,163,148,106.0,2.05,30,0,northeastern_university,reject,15
316,163,153,103.0,2.14,9,3,northeastern_university,reject,15
323,165,158,114.0,2.75,8,3,northeastern_university,reject,15
311,155,156,101,3.16,18,0,northeastern_university,reject,15
308,163,145,95.0,2.29,24,0,northeastern_university,reject,15
303,165,138,91.0,3.45,18,0,northeastern_university,reject,15
316,164,152,98.0,2.15,55,0,northeastern_university,reject,15
312,162,150,99.0,2.72,6,0,northeastern_university,reject,15
300,156,144,65.0,3.2,24,3,northeastern_university,reject,15
312,164,148,94.0,2.8,24,1,northeastern_university,reject,15
312,161,151,99.0,2.8,30,0,northeastern_university,reject,15
299,158,141,83.0,2.45,30,0,northeastern_university,reject,15
299,158,141,83.0,2.45,30,0,northeastern_university,reject,15
301,157,144,88.0,2.92,0,0,northeastern_university,reject,15
315,161,154,113.0,2.17,22,0,northeastern_university,reject,15
318,166,152,94.0,2.5,11,0,northeastern_university,reject,15
313,158,155,110.0,2.45,30,2,northeastern_university,reject,15
302,156,146,94.0,3.4,17,0,northeastern_university,reject,15
310,162,148,96.0,2.9,60,0,northeastern_university,reject,15
306,164,142,83.0,3.12,38,0,northeastern_university,reject,15
306,162,144,93.0,3.48,45,0,northeastern_university,reject,15
319,166,153,101.0,2.5,6,0,northeastern_university,reject,15
325,170,155,108.0,3.0,4,0,northeastern_university,reject,15
312,158,154,100.0,3.0,41,0,northeastern_university,reject,15
309,159,150,100.0,1.7,50,0,northeastern_university,reject,15
313,164,149,107.0,3.02,36,0,northeastern_university,reject,15
308,159,149,106.0,2.6,0,3,northeastern_university,reject,15
304,158,146,93.0,2.98,0,0,northeastern_university,reject,15
309,156,153,106.0,3.26,18,2,northeastern_university,reject,15
315,165,150,110.0,3.24,24,0,northeastern_university,reject,15
310,159,151,104.0,2.8,24,2,northeastern_university,reject,15
316,164,152,104.0,2.65,70,0,northeastern_university,reject,15
323,170,153,96.0,2.15,24,0,northeastern_university,reject,15
301,154,147,103.0,2.35,8,0,northeastern_university,reject,15
304,155,149,105.0,2.0,26,0,northeastern_university,reject,15
314,161,153,106.0,3.1,30,0,northeastern_university,reject,15
300,158,142,91.0,3.04,15,3,northeastern_university,reject,15
308,156,152,97.0,3.03,24,0,northeastern_university,reject,15
317,158,159,105.0,2.1,40,0,northeastern_university,reject,15
313,163,150,106.0,2.85,0,0,northeastern_university,reject,15
303,156,147,103.0,2.78,30,2,northeastern_university,reject,15
323,167,156,110.0,3.17,0,0,northeastern_university,reject,15
318,164,154,107.0,3.16,0,0,northeastern_university,reject,15
323,162,161,108.0,2.6,59,0,northeastern_university,reject,15
319,170,149,96.0,2.72,5,0,northeastern_university,reject,15
309,162,147,96.0,3.42,22,0,northeastern_university,reject,15
312,163,149,102.0,3.38,0,0,northeastern_university,reject,15
315,163,152,105.0,2.65,0,0,northeastern_university,reject,15
321,161,160,105.0,2.8,36,0,northeastern_university,reject,15
305,163,142,83.0,2.8,24,0,northeastern_university,reject,15
312,162,150,100.0,2.4,48,0,northeastern_university,reject,15
315,163,152,111.0,2.5,10,0,northeastern_university,reject,15
305,160,145,104.0,3.1,2,0,northeastern_university,reject,15
307,160,147,102.0,2.76,0,0,northeastern_university,reject,15
309,160,149,99.0,2.28,20,0,northeastern_university,reject,15
312,162,150,103.0,2.99,40,0,northeastern_university,reject,15
304,154,150,95.0,2.44,0,3,northeastern_university,reject,15
308,155,153,95.0,2.4,0,0,northeastern_university,reject,15
314,159,155,107.0,2.3,30,0,northeastern_university,reject,15
308,154,154,96.0,2.25,30,1,northeastern_university,reject,15
319,165,154,109.0,2.2,0,1,northeastern_university,reject,15
319,165,154,109.0,2.2,0,1,northeastern_university,reject,15
328,170,158,115.0,2.68,0,3,northeastern_university,reject,15
314,160,154,100.0,3.12,2,0,northeastern_university,reject,15
315,163,152,111.0,2.35,23,3,northeastern_university,reject,15
309,160,149,91.0,2.48,0,0,northeastern_university,reject,15
322,166,156,113.0,3.1,0,0,northeastern_university,reject,15
320,168,152,100.0,3.2,0,0,northeastern_university,reject,15
304,158,146,94.0,2.84,26,0,northeastern_university,reject,15
309,161,148,98.0,3.48,1,0,northeastern_university,reject,15
320,170,150,97.0,3.09,18,0,northeastern_university,reject,15
308,159,149,98.0,2.01,30,0,northeastern_university,reject,15
311,167,144,98.0,3.66,1,0,northeastern_university,reject,15
308,162,146,97.0,2.84,0,0,northeastern_university,reject,15
306,154,152,95.0,2.5,19,0,northeastern_university,reject,15
307,161,146,99.0,3.0,0,0,northeastern_university,reject,15
306,160,146,96.0,3.36,6,0,northeastern_university,reject,15
316,162,154,104.0,2.78,2,0,northeastern_university,reject,15
316,162,154,104.0,2.78,2,0,northeastern_university,reject,15
314,165,149,102.0,2.5,54,0,northeastern_university,reject,15
309,159,150,103.0,2.45,30,0,northeastern_university,reject,15
314,158,156,107.0,2.61,4,0,northeastern_university,reject,15
305,159,146,93.0,2.18,30,0,northeastern_university,reject,15
298,154,144,65.0,3.26,11,0,northeastern_university,reject,15
310,157,153,108.0,1.95,32,0,northeastern_university,reject,15
309,166,143,89.0,2.15,23,0,northeastern_university,reject,15
320,166,154,111.0,2.98,22,0,northeastern_university,reject,15
309,162,147,103.0,2.68,21,3,northeastern_university,reject,15
310,163,147,107.0,2.9,0,0,northeastern_university,reject,15
316,163,153,107.0,2.6,0,0,northeastern_university,reject,15
316,163,153,112.0,2.6,12,3,northeastern_university,reject,15
314,158,156,105.0,2.35,20,3,northeastern_university,reject,15
309,158,151,106.0,2.5,7,0,northeastern_university,reject,15
313,161,152,92.0,3.26,9,0,northeastern_university,reject,15
317,161,156,109.0,3.45,6,0,northeastern_university,reject,15
317,161,156,109.0,3.45,6,0,northeastern_university,reject,15
314,162,152,108.0,3.54,0,0,northeastern_university,reject,15
319,162,157,109.0,1.86,0,3,northeastern_university,reject,15
316,164,152,104.0,3.0,0,0,northeastern_university,reject,15
313,170,143,102.0,3.42,21,0,northeastern_university,reject,15
319,165,154,104.0,3.26,0,0,northeastern_university,reject,15
311,159,152,100.0,3.6,0,0,northeastern_university,reject,15
313,163,150,107.0,3.31,0,0,northeastern_university,reject,15
302,157,145,97.0,3.2,24,1,northeastern_university,reject,15
321,169,152,108.0,1.96,0,0,northeastern_university,reject,15
305,157,148,97.0,2.45,0,0,northeastern_university,reject,15
312,163,149,107.0,3.22,0,0,northeastern_university,reject,15
313,161,152,113.0,2.6,41,0,northeastern_university,reject,15
318,168,150,104.0,2.3,30,3,northeastern_university,reject,15
310,164,146,85.0,2.53,6,0,northeastern_university,reject,15
321,167,154,104.0,2.25,18,0,northeastern_university,reject,15
308,158,150,101.0,2.8,22,0,northeastern_university,reject,15
325,168,157,114.0,2.89,0,0,northeastern_university,reject,15
308,161,147,104.0,2.43,24,3,northeastern_university,reject,15
309,155,154,114.0,3.44,0,0,northeastern_university,reject,15
316,162,154,102.0,2.94,60,0,northeastern_university,reject,15
312,163,149,106.0,2.45,17,0,northeastern_university,reject,15
300,155,145,92.0,3.0,36,1,northeastern_university,reject,15
307,162,145,91.0,2.9,2,0,northeastern_university,reject,15
303,154,149,93.0,3.4,0,2,northeastern_university,reject,15
318,167,151,100.0,2.55,24,0,northeastern_university,reject,15
306,158,148,102.0,2.92,0,3,northeastern_university,reject,15
304,160,144,94.0,2.25,0,0,northeastern_university,reject,15
306,157,149,90.0,2.85,0,0,northeastern_university,reject,15
320,168,152,96.0,3.48,5,0,northeastern_university,reject,15
306,161,145,91.0,3.65,20,0,northeastern_university,reject,15
325,166,159,104.0,2.76,2,0,northeastern_university,reject,15
311,163,148,105.0,2.4,0,0,northeastern_university,reject,15
307,162,145,108.0,2.05,0,0,northeastern_university,reject,15
309,159,150,105.0,2.35,0,0,northeastern_university,reject,15
306,162,144,99.0,1.99,10,0,northeastern_university,reject,15
311,164,147,106.0,3.34,1,3,northeastern_university,reject,15
313,155,158,106.0,2.23,0,0,northeastern_university,reject,15
326,170,156,108.0,1.8,0,0,northeastern_university,reject,15
324,165,159,114.0,3.57,30,0,northeastern_university,reject,15
311,164,147,96.0,3.0,6,0,northeastern_university,reject,15
322,162,160,108.0,2.2,0,0,northeastern_university,reject,15
311,158,153,108.0,2.2,15,2,northeastern_university,reject,15
320,168,152,110.0,2.5,30,0,northeastern_university,reject,15
313,166,147,97.0,3.32,0,0,northeastern_university,reject,15
322,168,154,114.0,3.2,0,3,northeastern_university,reject,15
305,157,148,102.0,2.05,0,0,northeastern_university,reject,15
311,161,150,95.0,2.22,0,0,northeastern_university,reject,15
316,164,152,102.0,2.55,30,0,northeastern_university,reject,15
310,161,149,106.0,3.1,0,0,northeastern_university,reject,15
310,161,149,106.0,3.1,0,0,northeastern_university,reject,15
316,161,155,102.0,2.15,20,0,northeastern_university,reject,15
312,163,149,99.0,2.78,0,2,northeastern_university,reject,15
307,159,148,93.0,2.5,0,3,northeastern_university,reject,15
313,161,152,103.0,2.21,0,2,northeastern_university,reject,15
322,165,157,110.0,2.11,0,0,northeastern_university,reject,15
306,158,148,104.0,2.5,30,0,northeastern_university,reject,15
323,163,160,108.0,2.03,20,0,northeastern_university,reject,15
309,159,150,105.0,2.8,0,0,northeastern_university,reject,15
310,165,145,95.0,3.05,32,0,northeastern_university,reject,15
308,158,150,109.0,2.1,0,0,northeastern_university,reject,15
306,159,147,97.0,2.12,10,0,northeastern_university,reject,15
320,163,157,108.0,2.3,0,2,northeastern_university,reject,15
306,161,145,96.0,3.19,0,0,northeastern_university,reject,15
312,162,150,103.0,2.56,0,0,northeastern_university,reject,15
310,160,150,110.0,2.5,0,0,northeastern_university,reject,15
310,160,150,94.0,3.24,0,3,northeastern_university,reject,15
310,160,150,94.0,3.24,0,3,northeastern_university,reject,15
306,161,145,104.0,3.02,22,0,northeastern_university,reject,15
308,159,149,93.0,2.46,30,3,northeastern_university,reject,15
318,165,153,107.0,3.0,0,0,northeastern_university,reject,15
311,164,147,108.0,3.0,0,3,northeastern_university,reject,15
307,160,147,97.0,2.05,10,3,northeastern_university,reject,15
318,164,154,117.0,2.44,30,0,northeastern_university,reject,15
307,155,152,110.0,2.0,12,0,northeastern_university,reject,15
313,162,151,96.0,2.86,0,0,northeastern_university,reject,15
321,167,154,108.0,2.35,10,0,northeastern_university,reject,15
318,168,150,102.0,2.81,10,0,northeastern_university,reject,15
312,166,146,90.0,3.94,10,0,northeastern_university,reject,15
320,165,155,113.0,2.4,14,0,northeastern_university,reject,15
304,161,143,92.0,3.6,24,0,northeastern_university,reject,15
320,168,152,96.0,3.14,20,0,northeastern_university,reject,15
308,158,150,99.0,2.4,16,0,northeastern_university,reject,15
317,167,150,103.0,2.35,30,2,northeastern_university,reject,15
317,167,150,103.0,2.35,30,2,northeastern_university,reject,15
313,163,150,99.0,2.9,30,0,northeastern_university,reject,15
296,158,138,98.0,2.1,30,0,northeastern_university,reject,15
310,165,145,100.0,2.15,30,3,northeastern_university,reject,15
313,162,151,110.0,2.65,30,0,northeastern_university,reject,15
315,163,152,95.0,2.35,30,3,northeastern_university,reject,15
308,163,145,104.0,2.17,30,1,northeastern_university,reject,15
322,170,152,101.0,2.4,30,0,northeastern_university,reject,15
325,169,156,104.0,2.6,30,1,northeastern_university,reject,15
304,157,147,95.0,3.29,30,0,northeastern_university,reject,15
307,160,147,88.0,3.0,36,0,rochester_institute_of_technology,accept,66
307,160,147,88.0,3.0,36,0,rochester_institute_of_technology,accept,66
319,168,151,106.0,2.05,38,0,rochester_institute_of_technology,accept,66
312,162,150,101,2.94,20,3,rochester_institute_of_technology,accept,66
302,158,144,93.0,2.62,0,0,rochester_institute_of_technology,accept,66
314,162,152,104.0,2.52,34,0,rochester_institute_of_technology,accept,66
306,159,147,96.0,3.18,2,0,rochester_institute_of_technology,accept,66
317,161,156,106.0,2.01,0,0,rochester_institute_of_technology,accept,66
321,167,154,107.0,2.25,0,0,rochester_institute_of_technology,accept,66
318,169,149,104.0,3.36,14,3,rochester_institute_of_technology,accept,66
310,160,150,103.0,2.4,17,0,rochester_institute_of_technology,accept,66
322,167,155,114,3.16,2,0,rochester_institute_of_technology,accept,66
311,159,152,105.0,3.04,24,3,rochester_institute_of_technology,accept,66
310,160,150,98.0,3.08,0,3,rochester_institute_of_technology,accept,66
308,159,149,75.0,2.09,27,3,rochester_institute_of_technology,accept,66
313,161,152,98.0,3.03,0,0,rochester_institute_of_technology,accept,66
316,163,153,100.0,3.12,24,0,rochester_institute_of_technology,accept,66
316,167,149,101.0,3.08,32,0,rochester_institute_of_technology,accept,66
311,161,150,99.0,3.0,2,3,rochester_institute_of_technology,accept,66
314,161,153,109.0,3.0,24,2,rochester_institute_of_technology,accept,66
314,161,153,109.0,3.0,24,2,rochester_institute_of_technology,accept,66
310,164,146,65.0,3.03,0,0,rochester_institute_of_technology,accept,66
314,163,151,98.0,3.12,18,0,rochester_institute_of_technology,accept,66
315,163,152,97.0,3.32,0,0,rochester_institute_of_technology,accept,66
310,160,150,93.0,3.6,1,0,rochester_institute_of_technology,accept,66
312,169,143,75.0,3.42,6,0,rochester_institute_of_technology,accept,66
305,160,145,97.0,3.4,12,3,rochester_institute_of_technology,accept,66
318,166,152,96.0,2.68,28,0,rochester_institute_of_technology,accept,66
318,169,149,98.0,3.14,6,0,rochester_institute_of_technology,accept,66
305,161,144,101.0,2.84,0,0,rochester_institute_of_technology,accept,66
314,159,155,114,1.82,25,0,rochester_institute_of_technology,accept,66
318,163,155,101.0,2.25,4,0,rochester_institute_of_technology,accept,66
322,163,159,106.0,2.71,2,2,rochester_institute_of_technology,accept,66
311,166,145,97.0,3.35,0,0,rochester_institute_of_technology,accept,66
310,160,150,102.0,3.14,5,0,rochester_institute_of_technology,accept,66
316,168,148,75.0,3.24,19,3,rochester_institute_of_technology,accept,66
317,168,149,104.0,3.06,19,0,rochester_institute_of_technology,accept,66
312,160,152,104.0,2.96,32,3,rochester_institute_of_technology,accept,66
327,167,160,75.0,3.23,0,0,rochester_institute_of_technology,accept,66
322,170,152,101.0,3.53,3,0,rochester_institute_of_technology,accept,66
322,170,152,101.0,3.53,3,0,rochester_institute_of_technology,accept,66
322,164,158,75.0,2.65,30,0,rochester_institute_of_technology,accept,66
318,164,154,98.0,2.56,28,0,rochester_institute_of_technology,accept,66
317,162,155,113.0,3.14,18,0,rochester_institute_of_technology,accept,66
301,152,149,87.0,2.68,33,0,rochester_institute_of_technology,accept,66
306,159,147,97.0,2.45,19,0,rochester_institute_of_technology,accept,66
322,166,156,107.0,3.48,26,0,rochester_institute_of_technology,accept,66
309,163,146,102.0,3.1,33,0,rochester_institute_of_technology,accept,66
315,158,157,113.0,2.38,17,2,rochester_institute_of_technology,accept,66
311,162,149,105.0,3.18,31,3,rochester_institute_of_technology,accept,66
309,168,141,107.0,2.25,28,0,rochester_institute_of_technology,accept,66
309,160,149,104.0,3.66,33,1,rochester_institute_of_technology,accept,66
325,163,162,106.0,2.88,7,0,rochester_institute_of_technology,accept,66
314,152,162,99.0,2.55,38,0,rochester_institute_of_technology,accept,66
315,162,153,99.0,2.94,2,0,rochester_institute_of_technology,accept,66
319,165,154,102.0,2.64,13,0,rochester_institute_of_technology,accept,66
300,159,141,65.0,3.29,17,0,rochester_institute_of_technology,accept,66
312,163,149,100.0,2.88,27,0,rochester_institute_of_technology,accept,66
311,162,149,99.0,2.95,0,3,rochester_institute_of_technology,accept,66
305,161,144,94.0,3.26,10,0,rochester_institute_of_technology,accept,66
313,166,147,101,3.01,2,0,rochester_institute_of_technology,accept,66
311,162,149,99.0,2.8,0,0,rochester_institute_of_technology,accept,66
314,164,150,90.0,2.3,42,0,rochester_institute_of_technology,accept,66
305,160,145,98.0,2.68,1,3,rochester_institute_of_technology,accept,66
318,160,158,112.0,2.31,5,3,rochester_institute_of_technology,accept,66
317,162,155,110.0,3.19,2,0,rochester_institute_of_technology,accept,66
314,163,151,101,3.27,27,0,rochester_institute_of_technology,accept,66
315,166,149,96.0,3.45,32,0,rochester_institute_of_technology,accept,66
324,170,154,108.0,2.8,19,0,rochester_institute_of_technology,accept,66
306,160,146,93.0,2.55,25,0,rochester_institute_of_technology,accept,66
307,153,154,101,3.27,12,0,rochester_institute_of_technology,accept,66
322,168,154,114,2.94,0,0,rochester_institute_of_technology,accept,66
326,167,159,111.0,2.95,12,1,rochester_institute_of_technology,accept,66
300,159,141,65.0,3.29,18,0,rochester_institute_of_technology,accept,66
312,161,151,111.0,2.68,12,0,rochester_institute_of_technology,accept,66
300,159,141,65.0,3.29,18,0,rochester_institute_of_technology,accept,66
312,161,151,111.0,2.68,12,0,rochester_institute_of_technology,accept,66
294,156,138,90.0,2.25,27,0,rochester_institute_of_technology,accept,66
310,165,145,94.0,2.9,36,0,rochester_institute_of_technology,accept,66
309,160,149,102.0,2.4,20,3,rochester_institute_of_technology,accept,66
309,160,149,102.0,2.4,20,3,rochester_institute_of_technology,accept,66
317,161,156,114,2.8,10,0,rochester_institute_of_technology,accept,66
322,166,156,112.0,3.38,0,0,rochester_institute_of_technology,accept,66
318,163,155,90.0,1.8,48,0,rochester_institute_of_technology,accept,66
307,157,150,93.0,3.05,25,0,rochester_institute_of_technology,accept,66
295,155,140,92.0,2.23,43,0,rochester_institute_of_technology,accept,66
304,155,149,107.0,2.92,22,0,rochester_institute_of_technology,accept,66
315,165,150,101,3.0,36,0,rochester_institute_of_technology,accept,66
317,160,157,111.0,2.61,36,0,rochester_institute_of_technology,accept,66
340,170,170,120.0,4.0,0,0,rochester_institute_of_technology,accept,66
303,160,143,65.0,2.63,0,2,rochester_institute_of_technology,accept,66
300,160,140,99.0,2.71,24,3,rochester_institute_of_technology,accept,66
316,164,152,98.0,3.26,33,0,rochester_institute_of_technology,accept,66
315,158,157,114.0,3.55,0,0,rochester_institute_of_technology,accept,66
312,167,145,93.0,3.32,12,0,rochester_institute_of_technology,accept,66
309,160,149,101.0,3.11,20,3,rochester_institute_of_technology,accept,66
311,164,147,109.0,3.02,31,0,rochester_institute_of_technology,accept,66
318,167,151,111.0,3.57,0,0,rochester_institute_of_technology,accept,66
318,167,151,111.0,3.57,0,0,rochester_institute_of_technology,accept,66
319,169,150,105.0,3.3,0,0,rochester_institute_of_technology,accept,66
325,167,158,114,3.4,2,0,rochester_institute_of_technology,accept,66
313,161,152,98.0,3.03,2,0,rochester_institute_of_technology,accept,66
313,160,153,98.0,3.49,7,3,rochester_institute_of_technology,accept,66
313,156,157,107.0,2.07,0,2,rochester_institute_of_technology,accept,66
301,159,142,85.0,3.15,20,2,rochester_institute_of_technology,accept,66
310,156,154,103.0,3.17,18,0,rochester_institute_of_technology,accept,66
305,157,148,101,2.86,30,0,rochester_institute_of_technology,accept,66
319,167,152,96.0,3.61,2,3,rochester_institute_of_technology,accept,66
310,160,150,93.0,2.26,26,0,rochester_institute_of_technology,accept,66
323,164,159,110.0,3.12,12,0,rochester_institute_of_technology,accept,66
316,163,153,106.0,3.88,6,0,rochester_institute_of_technology,accept,66
312,162,150,106.0,2.96,0,0,rochester_institute_of_technology,accept,66
303,161,142,96.0,2.8,0,0,rochester_institute_of_technology,accept,66
314,168,146,109.0,3.26,13,0,rochester_institute_of_technology,accept,66
316,153,163,105.0,2.96,24,0,rochester_institute_of_technology,accept,66
309,163,146,96.0,3.48,12,0,rochester_institute_of_technology,accept,66
300,155,145,105.0,3.23,0,3,rochester_institute_of_technology,accept,66
319,163,156,112.0,3.4,0,0,rochester_institute_of_technology,accept,66
307,163,144,94.0,2.84,0,0,rochester_institute_of_technology,accept,66
307,163,144,94.0,2.84,0,0,rochester_institute_of_technology,accept,66
312,165,147,107.0,2.96,30,3,rochester_institute_of_technology,accept,66
317,165,152,96.0,2.98,4,0,rochester_institute_of_technology,accept,66
313,164,149,100.0,2.82,1,3,rochester_institute_of_technology,accept,66
321,170,151,103.0,3.6,6,3,rochester_institute_of_technology,accept,66
308,159,149,98.0,2.2,29,0,rochester_institute_of_technology,accept,66
313,163,150,97.0,2.52,19,0,rochester_institute_of_technology,accept,66
300,155,145,105.0,3.23,0,3,rochester_institute_of_technology,accept,66
307,155,152,99.0,2.92,11,0,rochester_institute_of_technology,accept,66
310,165,145,101,3.17,2,0,rochester_institute_of_technology,accept,66
318,163,155,113.0,3.0,0,0,rochester_institute_of_technology,accept,66
318,162,156,98.0,1.9,21,0,rochester_institute_of_technology,accept,66
309,161,148,101.0,3.05,5,0,rochester_institute_of_technology,accept,66
319,161,158,115.0,3.65,2,3,rochester_institute_of_technology,accept,66
313,163,150,101,3.0,18,0,rochester_institute_of_technology,accept,66
314,163,151,108.0,3.48,27,3,rochester_institute_of_technology,accept,66
314,160,154,109.0,3.41,22,2,rochester_institute_of_technology,accept,66
313,169,144,100.0,3.07,20,0,rochester_institute_of_technology,accept,66
315,161,154,104.0,2.18,4,1,rochester_institute_of_technology,accept,66
308,161,147,105.0,2.92,1,0,rochester_institute_of_technology,accept,66
316,164,152,98.0,3.16,23,3,rochester_institute_of_technology,accept,66
316,164,152,98.0,3.16,23,3,rochester_institute_of_technology,accept,66
315,161,154,107.0,2.3,36,0,rochester_institute_of_technology,accept,66
304,160,144,101,3.52,9,3,rochester_institute_of_technology,accept,66
310,165,145,111.0,3.56,0,3,rochester_institute_of_technology,accept,66
318,166,152,104.0,3.47,9,3,rochester_institute_of_technology,accept,66
307,163,144,93.0,3.2,1,0,rochester_institute_of_technology,accept,66
296,153,143,97.0,1.88,41,0,rochester_institute_of_technology,accept,66
317,162,155,111.0,3.24,1,0,rochester_institute_of_technology,accept,66
303,158,145,99.0,3.86,12,0,rochester_institute_of_technology,accept,66
313,160,153,108.0,3.27,7,1,rochester_institute_of_technology,accept,66
313,163,150,75.0,3.46,17,3,rochester_institute_of_technology,accept,66
301,157,144,87.0,2.25,23,3,rochester_institute_of_technology,accept,66
325,170,155,115.0,3.48,5,0,rochester_institute_of_technology,accept,66
315,160,155,90.0,2.9,4,0,rochester_institute_of_technology,accept,66
300,155,145,95.0,3.14,18,1,rochester_institute_of_technology,accept,66
312,163,149,100.0,2.1,30,1,rochester_institute_of_technology,accept,66
322,165,157,110.0,2.4,30,0,rochester_institute_of_technology,accept,66
311,159,152,114,3.34,43,0,rochester_institute_of_technology,accept,66
311,159,152,114,3.34,43,0,rochester_institute_of_technology,accept,66
318,165,153,106.0,2.97,1,0,rochester_institute_of_technology,accept,66
314,159,155,106.0,2.95,3,0,rochester_institute_of_technology,accept,66
300,156,144,88.0,3.16,14,0,rochester_institute_of_technology,accept,66
300,156,144,0,2.63,10,0,rochester_institute_of_technology,accept,66
301,156,145,101,2.54,2,0,rochester_institute_of_technology,accept,66
302,157,145,96.0,2.88,16,3,rochester_institute_of_technology,accept,66
316,169,147,99.0,3.12,3,0,rochester_institute_of_technology,accept,66
314,163,151,0,2.87,27,0,rochester_institute_of_technology,accept,66
312,163,149,87.0,2.81,30,1,rochester_institute_of_technology,accept,66
308,158,150,91.0,2.18,0,0,rochester_institute_of_technology,accept,66
299,158,141,0,2.1,31,1,rochester_institute_of_technology,accept,66
303,151,152,0,2.0,14,3,rochester_institute_of_technology,accept,66
314,167,147,75.0,3.32,0,0,rochester_institute_of_technology,accept,66
318,162,156,0,3.0,2,0,rochester_institute_of_technology,accept,66
320,164,156,114.0,3.05,2,0,rochester_institute_of_technology,accept,66
316,167,149,109.0,2.92,2,0,rochester_institute_of_technology,accept,66
316,167,149,109.0,2.92,2,0,rochester_institute_of_technology,accept,66
312,162,150,102.0,3.46,8,3,rochester_institute_of_technology,accept,66
317,164,153,0,1.71,38,0,rochester_institute_of_technology,accept,66
310,162,148,97.0,2.5,0,3,rochester_institute_of_technology,accept,66
320,160,160,0,2.4,10,0,rochester_institute_of_technology,accept,66
321,158,163,0,2.45,31,0,rochester_institute_of_technology,accept,66
313,160,153,108.0,3.02,20,3,rochester_institute_of_technology,accept,66
315,160,155,111.0,1.75,30,0,rochester_institute_of_technology,accept,66
316,167,149,107.0,2.99,0,0,rochester_institute_of_technology,accept,66
303,158,145,101.0,3.62,0,3,rochester_institute_of_technology,accept,66
308,158,150,105.0,3.21,0,0,rochester_institute_of_technology,accept,66
317,163,154,111.0,2.82,24,3,rochester_institute_of_technology,accept,66
317,165,152,116.0,3.6,0,3,rochester_institute_of_technology,accept,66
310,162,148,92.0,3.2,0,0,rochester_institute_of_technology,accept,66
307,161,146,101.0,3.32,20,0,rochester_institute_of_technology,accept,66
311,161,150,98.0,2.6,36,0,rochester_institute_of_technology,accept,66
317,160,157,115.0,3.32,1,0,rochester_institute_of_technology,accept,66
317,160,157,110.0,3.12,24,0,rochester_institute_of_technology,accept,66
313,163,150,106.0,3.42,0,1,rochester_institute_of_technology,accept,66
325,170,155,114.0,3.24,0,0,rochester_institute_of_technology,accept,66
303,152,151,110.0,3.0,0,1,rochester_institute_of_technology,accept,66
308,162,146,96.0,3.15,36,0,rochester_institute_of_technology,accept,66
323,163,160,110.0,2.96,0,0,rochester_institute_of_technology,accept,66
301,156,145,100.0,2.57,0,3,rochester_institute_of_technology,accept,66
312,161,151,108.0,2.72,4,0,rochester_institute_of_technology,accept,66
299,151,148,104.0,2.1,8,2,rochester_institute_of_technology,accept,66
311,162,149,107.0,3.13,3,3,rochester_institute_of_technology,accept,66
311,165,146,104.0,2.82,0,0,rochester_institute_of_technology,accept,66
281,144,137,65.0,2.25,35,0,rochester_institute_of_technology,reject,66
281,144,137,65.0,2.25,35,0,rochester_institute_of_technology,reject,66
316,163,153,104.0,2.75,27,0,rochester_institute_of_technology,reject,66
288,151,137,89.0,2.1,38,3,rochester_institute_of_technology,reject,66
316,166,150,100.0,3.35,48,3,rochester_institute_of_technology,reject,66
299,161,138,85.0,3.03,33,0,rochester_institute_of_technology,reject,66
310,166,144,98.0,3.16,33,0,rochester_institute_of_technology,reject,66
305,160,145,105.0,2.52,6,0,rochester_institute_of_technology,reject,66
308,162,146,93.0,2.57,0,2,rochester_institute_of_technology,reject,66
297,155,142,88.0,3.12,0,0,rochester_institute_of_technology,reject,66
297,157,140,101,2.77,6,0,rochester_institute_of_technology,reject,66
300,155,145,84.0,1.71,40,0,rochester_institute_of_technology,reject,66
312,162,150,102.0,2.52,30,3,rochester_institute_of_technology,reject,66
297,154,143,91.0,2.48,0,0,rochester_institute_of_technology,reject,66
298,155,143,101.0,3.08,0,0,rochester_institute_of_technology,reject,66
300,158,142,83.0,2.45,45,0,rochester_institute_of_technology,reject,66
291,160,131,65.0,3.22,6,0,rochester_institute_of_technology,reject,66
307,158,149,114,2.63,34,0,rochester_institute_of_technology,reject,66
295,155,140,90.0,2.69,30,0,rochester_institute_of_technology,reject,66
316,160,156,103.0,2.7,16,1,rochester_institute_of_technology,reject,66
296,158,138,84.0,3.62,4,3,rochester_institute_of_technology,reject,66
296,158,138,84.0,3.62,4,3,rochester_institute_of_technology,reject,66
304,156,148,113.0,3.04,12,0,rochester_institute_of_technology,reject,66
304,156,148,113.0,3.04,12,0,rochester_institute_of_technology,reject,66
322,168,154,113.0,3.52,37,3,rochester_institute_of_technology,reject,66
308,157,151,96.0,3.01,15,0,rochester_institute_of_technology,reject,66
313,166,147,0,1.99,29,0,rochester_institute_of_technology,reject,66
303,154,149,98.0,2.4,0,0,rochester_institute_of_technology,reject,66
303,158,145,65.0,2.77,0,0,rochester_institute_of_technology,reject,66
305,158,147,91.0,3.02,0,0,rochester_institute_of_technology,reject,66
303,160,143,93.0,3.03,19,0,rochester_institute_of_technology,reject,66
302,160,142,96.0,3.2,0,0,rochester_institute_of_technology,reject,66
302,156,146,103.0,2.2,39,0,rochester_institute_of_technology,reject,66
307,160,147,111.0,2.8,0,0,rochester_institute_of_technology,reject,66
320,164,156,112.0,2.33,15,3,rochester_institute_of_technology,reject,66
284,150,134,0,2.76,1,0,rochester_institute_of_technology,reject,66
297,155,142,78,3.36,6,0,rochester_institute_of_technology,reject,66
312,166,146,104.0,2.56,0,0,rochester_institute_of_technology,reject,66
299,159,140,0,2.81,1,0,rochester_institute_of_technology,reject,66
291,143,148,95.0,3.2,0,0,rochester_institute_of_technology,reject,66
302,160,142,97.0,3.12,5,2,rochester_institute_of_technology,reject,66
313,156,157,114,2.25,1,0,rochester_institute_of_technology,reject,66
292,150,142,117.0,2.56,5,3,rochester_institute_of_technology,reject,66
292,150,142,117.0,2.56,5,3,rochester_institute_of_technology,reject,66
308,162,146,95.0,3.1,0,2,rochester_institute_of_technology,reject,66
324,163,161,104.0,2.66,24,1,rochester_institute_of_technology,reject,66
302,158,144,96.0,2.66,3,0,rochester_institute_of_technology,reject,66
307,156,151,102.0,2.8,0,0,rochester_institute_of_technology,reject,66
298,157,141,91.0,1.76,28,3,rochester_institute_of_technology,reject,66
293,150,143,83.0,2.84,0,0,rochester_institute_of_technology,reject,66
302,160,142,92.0,2.81,16,0,rochester_institute_of_technology,reject,66
313,165,148,91.0,2.17,38,0,rochester_institute_of_technology,reject,66
317,165,152,105.0,2.16,1,3,rochester_institute_of_technology,reject,66
303,159,144,84.0,2.8,60,0,rochester_institute_of_technology,reject,66
312,167,145,90.0,2.54,15,1,rochester_institute_of_technology,reject,66
306,164,142,92.0,2.2,44,0,rochester_institute_of_technology,reject,66
313,166,147,91.0,2.64,32,0,rochester_institute_of_technology,reject,66
303,159,144,93.0,2.76,0,0,rochester_institute_of_technology,reject,66
305,161,144,91.0,2.25,15,0,rochester_institute_of_technology,reject,66
310,143,167,91.0,2.0,4,3,rochester_institute_of_technology,reject,66
304,157,147,93.0,2.46,3,0,rochester_institute_of_technology,reject,66
315,167,148,103.0,3.25,30,0,rochester_institute_of_technology,reject,66
294,152,142,82.0,2.22,0,0,rochester_institute_of_technology,reject,66
294,152,142,82.0,2.22,0,0,rochester_institute_of_technology,reject,66
307,158,149,91.0,2.36,24,0,rochester_institute_of_technology,reject,66
306,160,146,94.0,1.89,23,0,rochester_institute_of_technology,reject,66
312,161,151,109.0,2.11,0,3,rochester_institute_of_technology,reject,66
306,154,152,99.0,3.02,0,0,rochester_institute_of_technology,reject,66
300,144,156,92.0,2.98,2,3,rochester_institute_of_technology,reject,66
298,160,138,107.0,3.04,9,3,rochester_institute_of_technology,reject,66
305,161,144,89.0,3.09,12,0,rochester_institute_of_technology,reject,66
309,161,148,109.0,3.25,4,0,rochester_institute_of_technology,reject,66
309,162,147,103.0,3.49,18,0,rochester_institute_of_technology,reject,66
309,161,148,101,2.05,0,0,rochester_institute_of_technology,reject,66
307,161,146,97.0,1.8,21,0,rochester_institute_of_technology,reject,66
308,159,149,101,3.29,10,0,rochester_institute_of_technology,reject,66
318,167,151,102.0,3.06,10,0,rochester_institute_of_technology,reject,66
297,155,142,93.0,1.9,24,0,rochester_institute_of_technology,reject,66
305,163,142,84.0,3.31,24,0,rochester_institute_of_technology,reject,66
303,158,145,95.0,1.7,10,3,rochester_institute_of_technology,reject,66
305,157,148,104.0,2.8,6,1,rochester_institute_of_technology,reject,66
310,161,149,102.0,1.73,32,2,rochester_institute_of_technology,reject,66
310,161,149,98.0,3.26,1,3,rochester_institute_of_technology,reject,66
310,161,149,98.0,3.26,1,3,rochester_institute_of_technology,reject,66
306,162,144,110.0,3.37,24,0,rochester_institute_of_technology,reject,66
300,155,145,83.0,2.85,24,0,rochester_institute_of_technology,reject,66
300,158,142,91.0,3.04,15,3,rochester_institute_of_technology,reject,66
298,158,140,85.0,1.82,18,0,rochester_institute_of_technology,reject,66
304,154,150,95.0,2.44,0,3,rochester_institute_of_technology,reject,66
320,159,161,106.0,2.1,16,0,rochester_institute_of_technology,reject,66
309,166,143,89.0,2.15,23,0,rochester_institute_of_technology,reject,66
326,165,161,115.0,2.71,0,3,rochester_institute_of_technology,reject,66
313,164,149,107.0,3.02,36,0,rochester_institute_of_technology,reject,66
312,167,145,94.0,2.25,0,0,rochester_institute_of_technology,reject,66
303,155,148,106.0,2.1,40,0,rochester_institute_of_technology,reject,66
308,155,153,95.0,2.4,0,0,rochester_institute_of_technology,reject,66
302,156,146,105.0,2.3,0,0,rochester_institute_of_technology,reject,66
302,154,148,101.0,2.2,18,1,rochester_institute_of_technology,reject,66
308,152,156,108.0,2.33,39,0,rochester_institute_of_technology,reject,66
313,164,149,65.0,2.94,57,0,rochester_institute_of_technology,reject,66
300,156,144,87.0,2.6,18,0,rochester_institute_of_technology,reject,66
316,163,153,100.0,3.26,8,0,rochester_institute_of_technology,reject,66
318,166,152,113.0,3.15,10,0,rochester_institute_of_technology,reject,66
304,155,149,105.0,2.0,26,0,rochester_institute_of_technology,reject,66
304,155,149,105.0,2.0,26,0,rochester_institute_of_technology,reject,66
306,155,151,93.0,1.75,0,0,rochester_institute_of_technology,reject,66
319,162,157,109.0,1.86,0,3,rochester_institute_of_technology,reject,66
305,157,148,97.0,2.45,0,0,rochester_institute_of_technology,reject,66
309,162,147,103.0,2.68,21,3,rochester_institute_of_technology,reject,66
307,156,151,110.0,2.1,30,1,rochester_institute_of_technology,reject,66
304,160,144,94.0,2.25,0,0,rochester_institute_of_technology,reject,66
303,154,149,93.0,3.4,0,2,rochester_institute_of_technology,reject,66
309,155,154,114.0,3.44,0,0,rochester_institute_of_technology,reject,66
304,165,139,89.0,1.65,0,0,rochester_institute_of_technology,reject,66
307,160,147,97.0,2.05,10,3,rochester_institute_of_technology,reject,66
306,158,148,104.0,2.5,30,0,rochester_institute_of_technology,reject,66
298,159,139,80.0,2.05,0,3,rochester_institute_of_technology,reject,66
310,163,147,95.0,2.5,0,0,rochester_institute_of_technology,reject,66
315,164,151,90.0,2.2,0,0,rochester_institute_of_technology,reject,66
323,166,157,112.0,1.9,30,1,rochester_institute_of_technology,reject,66
298,157,141,84.0,2.3,0,2,rochester_institute_of_technology,reject,66
306,159,147,94.0,1.8,10,3,rochester_institute_of_technology,reject,66
295,152,143,90.0,2.0,0,1,rochester_institute_of_technology,reject,66
302,155,147,109.0,1.9,10,0,rochester_institute_of_technology,reject,66
304,154,150,93.0,1.71,20,3,rochester_institute_of_technology,reject,66
304,154,150,93.0,1.71,20,3,rochester_institute_of_technology,reject,66
301,157,144,91.0,2.27,10,0,rochester_institute_of_technology,reject,66
308,160,148,111.0,1.76,30,0,rochester_institute_of_technology,reject,66
316,162,154,106.0,2.05,0,0,rochester_institute_of_technology,reject,66
302,156,146,75.0,1.7,0,0,rochester_institute_of_technology,reject,66
299,156,143,91.0,2.3,10,0,rochester_institute_of_technology,reject,66
302,157,145,91.0,1.88,0,0,rochester_institute_of_technology,reject,66
296,153,143,89.0,1.9,0,0,rochester_institute_of_technology,reject,66
289,153,136,82.0,1.85,0,0,rochester_institute_of_technology,reject,66
294,158,136,87.0,2.05,0,0,rochester_institute_of_technology,reject,66
303,155,148,94.0,2.58,0,0,rochester_institute_of_technology,reject,66
300,158,142,94.0,2.99,30,0,rochester_institute_of_technology,reject,66
300,160,140,86.0,2.54,0,0,rochester_institute_of_technology,reject,66
321,170,151,111.0,3.63,17,0,rutgers_university_new_brunswick,accept,25
330,170,160,114.0,3.6,0,3,rutgers_university_new_brunswick,accept,25
322,170,152,108.0,3.45,10,3,rutgers_university_new_brunswick,accept,25
301,158,143,101,3.0,0,0,rutgers_university_new_brunswick,accept,25
320,169,151,106.0,3.29,0,0,rutgers_university_new_brunswick,accept,25
321,170,151,100.0,3.06,2,0,rutgers_university_new_brunswick,accept,25
323,169,154,112.0,3.59,3,0,rutgers_university_new_brunswick,accept,25
325,170,155,110.0,3.02,15,0,rutgers_university_new_brunswick,accept,25
320,170,150,75.0,3.4,2,0,rutgers_university_new_brunswick,accept,25
324,170,154,106.0,3.44,10,0,rutgers_university_new_brunswick,accept,25
328,170,158,110.0,3.39,6,0,rutgers_university_new_brunswick,accept,25
310,154,156,112.0,3.61,3,0,rutgers_university_new_brunswick,accept,25
311,165,146,95.0,3.52,0,0,rutgers_university_new_brunswick,accept,25
311,165,146,95.0,3.52,0,0,rutgers_university_new_brunswick,accept,25
318,164,154,108.0,3.36,0,0,rutgers_university_new_brunswick,accept,25
317,168,149,108.0,3.32,79,0,rutgers_university_new_brunswick,accept,25
311,163,148,98.0,3.0,54,0,rutgers_university_new_brunswick,accept,25
315,163,152,107.0,3.44,26,0,rutgers_university_new_brunswick,accept,25
328,170,158,113.0,3.24,3,0,rutgers_university_new_brunswick,accept,25
317,164,153,101.0,3.71,50,0,rutgers_university_new_brunswick,accept,25
334,170,164,116.0,2.81,36,0,rutgers_university_new_brunswick,accept,25
330,165,165,112.0,3.61,8,3,rutgers_university_new_brunswick,accept,25
310,165,145,95.0,2.4,0,0,rutgers_university_new_brunswick,accept,25
323,167,156,0,3.19,17,0,rutgers_university_new_brunswick,accept,25
326,168,158,0,3.63,0,0,rutgers_university_new_brunswick,accept,25
326,169,157,108.0,3.26,0,0,rutgers_university_new_brunswick,accept,25
330,169,161,116.0,3.43,12,2,rutgers_university_new_brunswick,accept,25
325,169,156,117.0,3.37,2,3,rutgers_university_new_brunswick,accept,25
326,170,156,109.0,2.8,0,3,rutgers_university_new_brunswick,accept,25
325,170,155,114.0,3.24,0,0,rutgers_university_new_brunswick,accept,25
318,169,149,102.0,3.18,15,3,rutgers_university_new_brunswick,accept,25
324,169,155,112.0,3.16,15,3,rutgers_university_new_brunswick,accept,25
319,168,151,106.0,3.3,34,0,rutgers_university_new_brunswick,accept,25
321,170,151,104.0,3.44,0,0,rutgers_university_new_brunswick,accept,25
318,168,150,0,3.0,24,3,rutgers_university_new_brunswick,accept,25
320,168,152,102.0,3.49,7,3,rutgers_university_new_brunswick,accept,25
318,168,150,107.0,3.27,1,0,rutgers_university_new_brunswick,accept,25
336,170,166,117.0,3.43,2,0,rutgers_university_new_brunswick,accept,25
330,170,160,106.0,3.7,12,3,rutgers_university_new_brunswick,accept,25
319,170,149,107.0,3.63,24,3,rutgers_university_new_brunswick,accept,25
328,170,158,108.0,3.21,0,0,rutgers_university_new_brunswick,accept,25
315,169,146,93.0,3.5,27,0,rutgers_university_new_brunswick,accept,25
325,164,161,107.0,3.73,51,0,rutgers_university_new_brunswick,accept,25
314,167,147,93.0,3.58,23,0,rutgers_university_new_brunswick,accept,25
318,167,151,108.0,3.24,30,0,rutgers_university_new_brunswick,accept,25
317,166,151,101,2.87,52,0,rutgers_university_new_brunswick,accept,25
328,168,160,108.0,2.1,24,0,rutgers_university_new_brunswick,accept,25
311,165,146,98.0,3.5,28,2,rutgers_university_new_brunswick,accept,25
321,163,158,108.0,2.35,29,0,rutgers_university_new_brunswick,accept,25
320,168,152,104.0,3.2,0,0,rutgers_university_new_brunswick,accept,25
323,164,159,109.0,2.79,5,0,rutgers_university_new_brunswick,accept,25
321,167,154,103.0,2.75,13,0,rutgers_university_new_brunswick,accept,25
320,170,150,108.0,3.13,0,3,rutgers_university_new_brunswick,accept,25
325,169,156,103.0,3.4,24,2,rutgers_university_new_brunswick,accept,25
317,167,150,95.0,3.16,0,3,rutgers_university_new_brunswick,accept,25
326,162,164,110.0,3.25,28,3,rutgers_university_new_brunswick,accept,25
320,165,155,109.0,3.05,8,0,rutgers_university_new_brunswick,accept,25
318,163,155,107.0,3.06,25,3,rutgers_university_new_brunswick,accept,25
316,167,149,106.0,3.68,3,3,rutgers_university_new_brunswick,accept,25
320,170,150,97.0,3.09,18,0,rutgers_university_new_brunswick,accept,25
320,170,150,97.0,3.09,18,0,rutgers_university_new_brunswick,accept,25
323,165,158,114.0,2.75,8,3,rutgers_university_new_brunswick,accept,25
322,167,155,113.0,3.49,0,3,rutgers_university_new_brunswick,accept,25
322,170,152,104.0,3.26,46,3,rutgers_university_new_brunswick,accept,25
325,170,155,114.0,3.17,30,0,rutgers_university_new_brunswick,accept,25
330,167,163,116.0,3.52,18,0,rutgers_university_new_brunswick,accept,25
323,169,154,105.0,2.67,20,1,rutgers_university_new_brunswick,accept,25
318,170,148,113.0,3.2,12,0,rutgers_university_new_brunswick,accept,25
329,169,160,111.0,3.13,0,3,rutgers_university_new_brunswick,accept,25
313,163,150,96.0,3.54,36,0,rutgers_university_new_brunswick,accept,25
314,165,149,90.0,2.15,0,3,rutgers_university_new_brunswick,accept,25
304,164,140,94.0,2.8,6,0,rutgers_university_new_brunswick,accept,25
323,162,161,117.0,3.42,2,0,rutgers_university_new_brunswick,accept,25
321,166,155,113.0,3.12,0,0,rutgers_university_new_brunswick,accept,25
316,170,146,98.0,2.84,30,0,rutgers_university_new_brunswick,accept,25
289,146,143,96.0,2.55,0,0,rutgers_university_new_brunswick,accept,25
304,164,140,94.0,3.12,6,0,rutgers_university_new_brunswick,accept,25
319,166,153,110.0,3.72,2,0,rutgers_university_new_brunswick,accept,25
334,168,166,116.0,2.88,2,0,rutgers_university_new_brunswick,accept,25
314,168,146,98.0,3.2,30,0,rutgers_university_new_brunswick,accept,25
322,170,152,107.0,3.52,31,0,rutgers_university_new_brunswick,accept,25
327,170,157,115.0,3.04,12,0,rutgers_university_new_brunswick,accept,25
329,169,160,107.0,2.92,5,0,rutgers_university_new_brunswick,accept,25
317,168,149,102.0,3.26,1,0,rutgers_university_new_brunswick,accept,25
329,167,162,117.0,3.47,2,0,rutgers_university_new_brunswick,accept,25
327,170,157,107.0,3.16,16,0,rutgers_university_new_brunswick,accept,25
326,167,159,110.0,2.54,21,0,rutgers_university_new_brunswick,accept,25
322,167,155,110.0,3.16,3,0,rutgers_university_new_brunswick,accept,25
320,168,152,102.0,2.8,18,0,rutgers_university_new_brunswick,accept,25
330,167,163,111.0,2.89,14,3,rutgers_university_new_brunswick,accept,25
314,162,152,107.0,3.44,18,0,rutgers_university_new_brunswick,accept,25
325,168,157,112.0,2.96,40,0,rutgers_university_new_brunswick,accept,25
316,166,150,106.0,3.2,15,3,rutgers_university_new_brunswick,accept,25
322,170,152,96.0,3.15,26,0,rutgers_university_new_brunswick,accept,25
327,168,159,113.0,3.69,30,3,rutgers_university_new_brunswick,accept,25
324,170,154,105.0,3.31,10,0,rutgers_university_new_brunswick,accept,25
317,169,148,97.0,2.5,10,3,rutgers_university_new_brunswick,accept,25
318,164,154,101.0,2.73,40,0,rutgers_university_new_brunswick,accept,25
322,167,155,112.0,3.7,30,0,rutgers_university_new_brunswick,accept,25
326,168,158,110.0,3.24,0,2,rutgers_university_new_brunswick,accept,25
319,168,151,110.0,3.14,10,3,rutgers_university_new_brunswick,accept,25
311,158,153,110.0,2.49,30,0,rutgers_university_new_brunswick,accept,25
321,167,154,114.0,3.48,0,0,rutgers_university_new_brunswick,accept,25
321,167,154,114.0,3.48,0,0,rutgers_university_new_brunswick,accept,25
316,166,150,100.0,3.05,0,0,rutgers_university_new_brunswick,accept,25
322,170,152,106.0,2.75,0,0,rutgers_university_new_brunswick,accept,25
319,164,155,109.0,2.65,0,3,rutgers_university_new_brunswick,accept,25
318,166,152,115.0,3.2,20,0,rutgers_university_new_brunswick,accept,25
316,165,151,111.0,3.28,10,3,rutgers_university_new_brunswick,reject,25
316,165,151,111.0,3.28,10,3,rutgers_university_new_brunswick,reject,25
321,164,157,106.0,3.65,29,3,rutgers_university_new_brunswick,reject,25
314,163,151,114,3.53,7,3,rutgers_university_new_brunswick,reject,25
320,170,150,113.0,3.26,2,3,rutgers_university_new_brunswick,reject,25
326,168,158,110.0,2.92,60,0,rutgers_university_new_brunswick,reject,25
307,165,142,102.0,2.84,18,0,rutgers_university_new_brunswick,reject,25
324,158,166,109.0,3.36,0,0,rutgers_university_new_brunswick,reject,25
300,157,143,99.0,3.3,30,0,rutgers_university_new_brunswick,reject,25
318,165,153,99.0,3.05,24,0,rutgers_university_new_brunswick,reject,25
323,167,156,110.0,2.89,42,0,rutgers_university_new_brunswick,reject,25
325,170,155,103.0,2.84,30,0,rutgers_university_new_brunswick,reject,25
312,162,150,102.0,2.52,30,3,rutgers_university_new_brunswick,reject,25
315,167,148,104.0,3.48,8,0,rutgers_university_new_brunswick,reject,25
322,170,152,101.0,2.81,25,3,rutgers_university_new_brunswick,reject,25
312,167,145,75.0,3.36,0,0,rutgers_university_new_brunswick,reject,25
321,169,152,97.0,2.92,27,0,rutgers_university_new_brunswick,reject,25
317,165,152,96.0,2.98,4,0,rutgers_university_new_brunswick,reject,25
317,165,152,96.0,2.98,4,0,rutgers_university_new_brunswick,reject,25
315,150,165,112.0,2.96,20,0,rutgers_university_new_brunswick,reject,25
325,166,159,110.0,3.24,13,0,rutgers_university_new_brunswick,reject,25
315,161,154,111.0,3.0,26,0,rutgers_university_new_brunswick,reject,25
322,164,158,105.0,3.11,9,3,rutgers_university_new_brunswick,reject,25
315,164,151,108.0,3.62,1,0,rutgers_university_new_brunswick,reject,25
318,168,150,0,3.39,2,0,rutgers_university_new_brunswick,reject,25
311,164,147,99.0,3.46,17,0,rutgers_university_new_brunswick,reject,25
311,164,147,99.0,2.85,11,0,rutgers_university_new_brunswick,reject,25
307,161,146,102.0,3.39,4,0,rutgers_university_new_brunswick,reject,25
309,163,146,96.0,3.48,12,0,rutgers_university_new_brunswick,reject,25
319,165,154,111.0,2.61,44,0,rutgers_university_new_brunswick,reject,25
321,167,154,107.0,2.25,0,0,rutgers_university_new_brunswick,reject,25
324,168,156,114.0,3.26,44,3,rutgers_university_new_brunswick,reject,25
299,151,148,101,3.0,35,0,rutgers_university_new_brunswick,reject,25
329,169,160,115.0,3.65,3,0,rutgers_university_new_brunswick,reject,25
317,168,149,106.0,2.83,15,0,rutgers_university_new_brunswick,reject,25
318,170,148,102.0,2.8,4,0,rutgers_university_new_brunswick,reject,25
319,164,155,113.0,1.9,94,0,rutgers_university_new_brunswick,reject,25
318,162,156,98.0,1.9,21,0,rutgers_university_new_brunswick,reject,25
318,164,154,102.0,2.92,0,0,rutgers_university_new_brunswick,reject,25
316,165,151,95.0,3.27,10,0,rutgers_university_new_brunswick,reject,25
321,168,153,97.0,3.19,19,1,rutgers_university_new_brunswick,reject,25
327,169,158,107.0,3.45,31,0,rutgers_university_new_brunswick,reject,25
307,158,149,114,2.63,34,0,rutgers_university_new_brunswick,reject,25
314,162,152,105.0,3.8,18,0,rutgers_university_new_brunswick,reject,25
305,160,145,98.0,2.84,2,3,rutgers_university_new_brunswick,reject,25
328,169,159,113.0,3.04,3,0,rutgers_university_new_brunswick,reject,25
313,165,148,102.0,2.86,41,0,rutgers_university_new_brunswick,reject,25
325,167,158,112.0,3.62,5,0,rutgers_university_new_brunswick,reject,25
329,170,159,108.0,3.38,16,0,rutgers_university_new_brunswick,reject,25
315,165,150,98.0,3.76,6,3,rutgers_university_new_brunswick,reject,25
320,165,155,103.0,3.59,4,0,rutgers_university_new_brunswick,reject,25
304,160,144,93.0,3.36,2,3,rutgers_university_new_brunswick,reject,25
317,165,152,100.0,3.27,0,0,rutgers_university_new_brunswick,reject,25
323,166,157,110.0,2.83,0,0,rutgers_university_new_brunswick,reject,25
320,161,159,113.0,2.7,82,0,rutgers_university_new_brunswick,reject,25
328,169,159,106.0,2.84,30,0,rutgers_university_new_brunswick,reject,25
319,163,156,113.0,3.24,0,0,rutgers_university_new_brunswick,reject,25
318,168,150,110.0,3.33,0,0,rutgers_university_new_brunswick,reject,25
323,169,154,113.0,3.23,31,2,rutgers_university_new_brunswick,reject,25
321,165,156,0,3.73,0,0,rutgers_university_new_brunswick,reject,25
317,166,151,102.0,3.5,13,0,rutgers_university_new_brunswick,reject,25
319,168,151,106.0,3.3,7,3,rutgers_university_new_brunswick,reject,25
325,167,158,114,3.4,2,0,rutgers_university_new_brunswick,reject,25
311,161,150,105.0,3.1,8,0,rutgers_university_new_brunswick,reject,25
324,166,158,105.0,2.62,1,0,rutgers_university_new_brunswick,reject,25
319,161,158,109.0,2.77,19,0,rutgers_university_new_brunswick,reject,25
331,168,163,115.0,3.36,2,0,rutgers_university_new_brunswick,reject,25
331,168,163,115.0,3.36,2,0,rutgers_university_new_brunswick,reject,25
314,160,154,112.0,2.92,18,0,rutgers_university_new_brunswick,reject,25
314,161,153,108.0,3.38,17,3,rutgers_university_new_brunswick,reject,25
314,168,146,103.0,3.26,24,0,rutgers_university_new_brunswick,reject,25
315,164,151,109.0,3.28,1,0,rutgers_university_new_brunswick,reject,25
324,167,157,117.0,3.32,57,0,rutgers_university_new_brunswick,reject,25
310,164,146,96.0,2.42,13,0,rutgers_university_new_brunswick,reject,25
318,169,149,103.0,3.08,22,0,rutgers_university_new_brunswick,reject,25
301,153,148,92.0,3.04,0,0,rutgers_university_new_brunswick,reject,25
321,169,152,105.0,2.47,6,3,rutgers_university_new_brunswick,reject,25
325,165,160,108.0,3.16,2,0,rutgers_university_new_brunswick,reject,25
310,158,152,104.0,3.6,0,0,rutgers_university_new_brunswick,reject,25
315,166,149,95.0,3.52,0,0,rutgers_university_new_brunswick,reject,25
328,170,158,107.0,2.96,31,0,rutgers_university_new_brunswick,reject,25
320,166,154,110.0,3.16,7,3,rutgers_university_new_brunswick,reject,25
324,163,161,110.0,3.64,28,0,rutgers_university_new_brunswick,reject,25
324,169,155,112.0,2.88,8,0,rutgers_university_new_brunswick,reject,25
324,169,155,112.0,2.88,8,0,rutgers_university_new_brunswick,reject,25
325,168,157,113.0,2.62,39,3,rutgers_university_new_brunswick,reject,25
321,164,157,110.0,1.21,4,3,rutgers_university_new_brunswick,reject,25
314,165,149,105.0,3.53,15,0,rutgers_university_new_brunswick,reject,25
317,162,155,111.0,3.65,2,0,rutgers_university_new_brunswick,reject,25
331,169,162,116.0,2.65,37,3,rutgers_university_new_brunswick,reject,25
318,166,152,104.0,3.47,9,3,rutgers_university_new_brunswick,reject,25
310,161,149,103.0,2.7,20,3,rutgers_university_new_brunswick,reject,25
306,158,148,101,2.1,8,0,rutgers_university_new_brunswick,reject,25
310,160,150,93.0,3.6,1,0,rutgers_university_new_brunswick,reject,25
315,162,153,109.0,3.12,5,0,rutgers_university_new_brunswick,reject,25
320,167,153,109.0,2.85,12,0,rutgers_university_new_brunswick,reject,25
316,161,155,114.0,3.34,0,0,rutgers_university_new_brunswick,reject,25
308,157,151,101.0,3.18,0,1,rutgers_university_new_brunswick,reject,25
317,163,154,109.0,2.55,0,0,rutgers_university_new_brunswick,reject,25
317,164,153,101,2.7,86,0,rutgers_university_new_brunswick,reject,25
305,160,145,114,3.2,2,0,rutgers_university_new_brunswick,reject,25
305,160,145,114,3.2,2,0,rutgers_university_new_brunswick,reject,25
328,167,161,109.0,2.79,15,0,rutgers_university_new_brunswick,reject,25
317,162,155,110.0,3.69,0,3,rutgers_university_new_brunswick,reject,25
306,157,149,103.0,2.6,1,0,rutgers_university_new_brunswick,reject,25
322,168,154,105.0,3.24,2,0,rutgers_university_new_brunswick,reject,25
311,161,150,100.0,2.65,31,0,rutgers_university_new_brunswick,reject,25
320,162,158,102.0,3.32,6,3,rutgers_university_new_brunswick,reject,25
314,165,149,0,2.95,6,0,rutgers_university_new_brunswick,reject,25
320,160,160,0,3.01,0,0,rutgers_university_new_brunswick,reject,25
326,170,156,102.0,3.02,0,0,rutgers_university_new_brunswick,reject,25
319,161,158,111.0,2.96,6,0,rutgers_university_new_brunswick,reject,25
330,160,170,95.0,3.1,60,0,rutgers_university_new_brunswick,reject,25
318,165,153,95.0,3.14,30,0,rutgers_university_new_brunswick,reject,25
322,168,154,111.0,2.96,16,3,rutgers_university_new_brunswick,reject,25
307,161,146,114,3.05,0,3,rutgers_university_new_brunswick,reject,25
315,164,151,108.0,3.18,17,3,rutgers_university_new_brunswick,reject,25
300,155,145,93.0,3.12,13,0,rutgers_university_new_brunswick,reject,25
328,165,163,109.0,3.57,6,0,rutgers_university_new_brunswick,reject,25
320,165,155,108.0,3.4,18,0,rutgers_university_new_brunswick,reject,25
319,161,158,98.0,2.45,50,0,rutgers_university_new_brunswick,reject,25
308,161,147,90.0,3.46,27,0,rutgers_university_new_brunswick,reject,25
307,160,147,75.0,3.48,11,0,rutgers_university_new_brunswick,reject,25
305,158,147,101,3.32,6,0,rutgers_university_new_brunswick,reject,25
320,168,152,106.0,2.92,17,0,rutgers_university_new_brunswick,reject,25
316,159,157,110.0,3.36,36,0,rutgers_university_new_brunswick,reject,25
313,163,150,96.0,3.45,0,0,rutgers_university_new_brunswick,reject,25
307,156,151,88.0,2.38,85,0,rutgers_university_new_brunswick,reject,25
314,164,150,0,3.03,0,0,rutgers_university_new_brunswick,reject,25
326,169,157,0,3.01,32,0,rutgers_university_new_brunswick,reject,25
313,164,149,107.0,2.88,18,0,rutgers_university_new_brunswick,reject,25
337,170,167,115.0,2.7,26,0,rutgers_university_new_brunswick,reject,25
337,170,167,115.0,2.7,26,0,rutgers_university_new_brunswick,reject,25
311,164,147,103.0,2.8,36,0,rutgers_university_new_brunswick,reject,25
316,165,151,99.0,2.84,26,0,rutgers_university_new_brunswick,reject,25
318,166,152,91.0,3.09,28,0,rutgers_university_new_brunswick,reject,25
314,158,156,111.0,3.33,23,0,rutgers_university_new_brunswick,reject,25
317,165,152,105.0,3.08,1,0,rutgers_university_new_brunswick,reject,25
320,165,155,118.0,3.18,31,0,rutgers_university_new_brunswick,reject,25
315,161,154,0,2.84,1,0,rutgers_university_new_brunswick,reject,25
326,163,163,110.0,3.34,24,0,rutgers_university_new_brunswick,reject,25
311,164,147,102.0,3.02,27,3,rutgers_university_new_brunswick,reject,25
323,165,158,109.0,2.88,2,0,rutgers_university_new_brunswick,reject,25
318,162,156,0,3.8,0,0,rutgers_university_new_brunswick,reject,25
328,163,165,0,2.25,0,0,rutgers_university_new_brunswick,reject,25
313,166,147,99.0,3.6,0,3,rutgers_university_new_brunswick,reject,25
320,165,155,0,3.6,0,0,rutgers_university_new_brunswick,reject,25
323,167,156,110.0,3.0,29,0,rutgers_university_new_brunswick,reject,25
323,167,156,110.0,3.0,29,0,rutgers_university_new_brunswick,reject,25
321,168,153,106.0,3.4,0,0,rutgers_university_new_brunswick,reject,25
319,163,156,110.0,2.88,2,0,rutgers_university_new_brunswick,reject,25
303,161,142,99.0,3.53,0,3,rutgers_university_new_brunswick,reject,25
330,169,161,0,2.78,8,2,rutgers_university_new_brunswick,reject,25
317,162,155,101.0,3.49,24,0,rutgers_university_new_brunswick,reject,25
317,169,148,95.0,3.24,0,0,rutgers_university_new_brunswick,reject,25
308,158,150,101.0,3.38,28,0,rutgers_university_new_brunswick,reject,25
316,162,154,106.0,3.52,16,0,rutgers_university_new_brunswick,reject,25
320,167,153,0,3.04,1,2,rutgers_university_new_brunswick,reject,25
314,170,144,96.0,3.12,5,0,rutgers_university_new_brunswick,reject,25
329,170,159,109.0,3.04,20,0,rutgers_university_new_brunswick,reject,25
315,166,149,98.0,3.36,1,3,rutgers_university_new_brunswick,reject,25
298,153,145,96.0,3.28,0,3,rutgers_university_new_brunswick,reject,25
315,166,149,108.0,3.13,15,3,rutgers_university_new_brunswick,reject,25
313,163,150,116.0,2.99,2,0,rutgers_university_new_brunswick,reject,25
314,157,157,111.0,3.21,0,0,rutgers_university_new_brunswick,reject,25
314,157,157,111.0,3.21,0,0,rutgers_university_new_brunswick,reject,25
318,164,154,0,3.26,16,0,rutgers_university_new_brunswick,reject,25
325,166,159,113.0,2.76,12,0,rutgers_university_new_brunswick,reject,25
304,158,146,91.0,2.91,0,3,rutgers_university_new_brunswick,reject,25
319,151,168,101.0,3.22,12,0,rutgers_university_new_brunswick,reject,25
304,162,142,96.0,2.98,0,0,rutgers_university_new_brunswick,reject,25
312,162,150,102.0,3.2,18,0,rutgers_university_new_brunswick,reject,25
323,162,161,111.0,3.56,15,0,rutgers_university_new_brunswick,reject,25
312,148,164,90.0,3.39,33,0,rutgers_university_new_brunswick,reject,25
319,166,153,97.0,3.42,21,0,rutgers_university_new_brunswick,reject,25
309,164,145,94.0,2.92,2,0,rutgers_university_new_brunswick,reject,25
312,158,154,107.0,2.92,60,0,rutgers_university_new_brunswick,reject,25
312,167,145,85.0,3.3,30,0,rutgers_university_new_brunswick,reject,25
311,167,144,99.0,3.18,7,0,rutgers_university_new_brunswick,reject,25
328,168,160,0,2.72,19,3,rutgers_university_new_brunswick,reject,25
318,166,152,104.0,3.44,40,0,rutgers_university_new_brunswick,reject,25
309,160,149,93.0,2.85,2,3,rutgers_university_new_brunswick,reject,25
321,168,153,103.0,2.3,2,0,rutgers_university_new_brunswick,reject,25
320,165,155,105.0,3.2,1,0,rutgers_university_new_brunswick,reject,25
304,160,144,87.0,2.25,40,0,rutgers_university_new_brunswick,reject,25
313,164,149,101.0,2.96,33,3,rutgers_university_new_brunswick,reject,25
316,166,150,0,3.58,0,0,rutgers_university_new_brunswick,reject,25
311,161,150,91.0,3.47,24,3,rutgers_university_new_brunswick,reject,25
305,165,140,86.0,3.06,24,0,rutgers_university_new_brunswick,reject,25
328,170,158,111.0,2.75,5,0,rutgers_university_new_brunswick,reject,25
318,163,155,106.0,3.18,28,0,rutgers_university_new_brunswick,reject,25
317,160,157,109.0,2.69,0,3,rutgers_university_new_brunswick,reject,25
312,163,149,98.0,3.34,30,0,rutgers_university_new_brunswick,reject,25
323,170,153,102.0,3.6,4,0,rutgers_university_new_brunswick,reject,25
319,170,149,0,3.32,0,3,rutgers_university_new_brunswick,reject,25
312,166,146,90.0,2.7,30,0,rutgers_university_new_brunswick,reject,25
320,169,151,109.0,3.92,12,3,state_university_of_new_york_at_stony_brook,accept,35
320,169,151,109.0,3.92,12,3,state_university_of_new_york_at_stony_brook,accept,35
317,166,151,114,3.48,1,0,state_university_of_new_york_at_stony_brook,accept,35
315,170,145,95.0,3.12,24,0,state_university_of_new_york_at_stony_brook,accept,35
329,166,163,114.0,3.25,3,0,state_university_of_new_york_at_stony_brook,accept,35
317,168,149,75.0,3.23,6,1,state_university_of_new_york_at_stony_brook,accept,35
324,166,158,107.0,3.47,36,0,state_university_of_new_york_at_stony_brook,accept,35
315,168,147,106.0,3.24,0,0,state_university_of_new_york_at_stony_brook,accept,35
324,169,155,112.0,3.77,19,0,state_university_of_new_york_at_stony_brook,accept,35
320,165,155,109.0,3.26,9,0,state_university_of_new_york_at_stony_brook,accept,35
316,163,153,109.0,3.75,3,3,state_university_of_new_york_at_stony_brook,accept,35
330,168,162,113.0,2.98,34,2,state_university_of_new_york_at_stony_brook,accept,35
315,163,152,105.0,2.05,33,0,state_university_of_new_york_at_stony_brook,accept,35
326,169,157,105.0,3.16,28,3,state_university_of_new_york_at_stony_brook,accept,35
319,167,152,104.0,3.13,34,0,state_university_of_new_york_at_stony_brook,accept,35
322,164,158,108.0,3.44,0,0,state_university_of_new_york_at_stony_brook,accept,35
320,169,151,109.0,3.92,12,3,state_university_of_new_york_at_stony_brook,accept,35
320,169,151,109.0,3.92,12,3,state_university_of_new_york_at_stony_brook,accept,35
315,170,145,95.0,3.12,24,0,state_university_of_new_york_at_stony_brook,accept,35
329,166,163,114.0,3.25,3,0,state_university_of_new_york_at_stony_brook,accept,35
320,164,156,75.0,3.24,12,0,state_university_of_new_york_at_stony_brook,accept,35
324,166,158,107.0,3.47,36,0,state_university_of_new_york_at_stony_brook,accept,35
315,168,147,106.0,3.24,0,0,state_university_of_new_york_at_stony_brook,accept,35
324,169,155,112.0,3.77,19,0,state_university_of_new_york_at_stony_brook,accept,35
327,168,159,109.0,3.46,14,0,state_university_of_new_york_at_stony_brook,accept,35
316,163,153,109.0,3.75,3,3,state_university_of_new_york_at_stony_brook,accept,35
330,168,162,113.0,2.98,34,2,state_university_of_new_york_at_stony_brook,accept,35
315,163,152,105.0,2.05,33,0,state_university_of_new_york_at_stony_brook,accept,35
334,166,168,120.0,3.54,1,3,state_university_of_new_york_at_stony_brook,accept,35
319,167,152,104.0,3.13,34,0,state_university_of_new_york_at_stony_brook,accept,35
322,164,158,108.0,3.44,0,0,state_university_of_new_york_at_stony_brook,accept,35
325,167,158,109.0,3.38,24,3,state_university_of_new_york_at_stony_brook,accept,35
318,166,152,111.0,3.48,22,0,state_university_of_new_york_at_stony_brook,accept,35
334,169,165,108.0,2.96,26,0,state_university_of_new_york_at_stony_brook,accept,35
326,169,157,111.0,3.35,6,0,state_university_of_new_york_at_stony_brook,accept,35
329,166,163,114.0,3.59,40,3,state_university_of_new_york_at_stony_brook,accept,35
328,169,159,109.0,3.64,0,0,state_university_of_new_york_at_stony_brook,accept,35
320,170,150,105.0,3.66,2,0,state_university_of_new_york_at_stony_brook,accept,35
323,168,155,110.0,3.28,26,0,state_university_of_new_york_at_stony_brook,accept,35
331,169,162,116.0,2.65,37,3,state_university_of_new_york_at_stony_brook,accept,35
321,164,157,119.0,3.0,3,0,state_university_of_new_york_at_stony_brook,accept,35
325,170,155,107.0,2.85,9,0,state_university_of_new_york_at_stony_brook,accept,35
304,161,143,100.0,3.88,28,3,state_university_of_new_york_at_stony_brook,accept,35
318,163,155,108.0,2.77,15,3,state_university_of_new_york_at_stony_brook,accept,35
324,166,158,109.0,3.68,13,0,state_university_of_new_york_at_stony_brook,accept,35
315,164,151,109.0,3.05,37,0,state_university_of_new_york_at_stony_brook,accept,35
325,170,155,105.0,2.98,40,0,state_university_of_new_york_at_stony_brook,accept,35
322,167,155,103.0,3.08,20,3,state_university_of_new_york_at_stony_brook,accept,35
311,160,151,75.0,3.8,0,3,state_university_of_new_york_at_stony_brook,accept,35
323,167,156,105.0,2.85,52,0,state_university_of_new_york_at_stony_brook,accept,35
312,164,148,105.0,3.48,45,0,state_university_of_new_york_at_stony_brook,accept,35
326,168,158,111.0,3.73,6,0,state_university_of_new_york_at_stony_brook,accept,35
321,164,157,105.0,3.39,36,0,state_university_of_new_york_at_stony_brook,accept,35
317,163,154,107.0,3.64,41,0,state_university_of_new_york_at_stony_brook,accept,35
316,152,164,93.0,2.98,0,0,state_university_of_new_york_at_stony_brook,accept,35
317,164,153,103.0,2.28,21,0,state_university_of_new_york_at_stony_brook,accept,35
315,162,153,75.0,3.43,16,0,state_university_of_new_york_at_stony_brook,accept,35
325,169,156,111.0,3.43,2,0,state_university_of_new_york_at_stony_brook,accept,35
317,163,154,111.0,3.44,36,0,state_university_of_new_york_at_stony_brook,accept,35
324,167,157,117.0,3.32,57,0,state_university_of_new_york_at_stony_brook,accept,35
318,165,153,99.0,3.05,24,0,state_university_of_new_york_at_stony_brook,accept,35
311,162,149,96.0,3.08,24,3,state_university_of_new_york_at_stony_brook,accept,35
315,160,155,106.0,3.76,4,0,state_university_of_new_york_at_stony_brook,accept,35
310,155,155,105.0,3.88,60,0,state_university_of_new_york_at_stony_brook,accept,35
310,155,155,105.0,3.88,60,0,state_university_of_new_york_at_stony_brook,accept,35
322,167,155,109.0,3.2,8,0,state_university_of_new_york_at_stony_brook,accept,35
321,164,157,105.0,3.7,18,3,state_university_of_new_york_at_stony_brook,accept,35
314,164,150,108.0,3.08,60,0,state_university_of_new_york_at_stony_brook,accept,35
322,168,154,100.0,3.54,12,3,state_university_of_new_york_at_stony_brook,accept,35
323,168,155,107.0,2.76,0,0,state_university_of_new_york_at_stony_brook,accept,35
315,170,145,101,3.6,0,0,state_university_of_new_york_at_stony_brook,accept,35
324,167,157,105.0,3.45,28,0,state_university_of_new_york_at_stony_brook,accept,35
314,166,148,93.0,3.04,21,0,state_university_of_new_york_at_stony_brook,accept,35
319,167,152,96.0,3.61,2,3,state_university_of_new_york_at_stony_brook,accept,35
321,168,153,103.0,3.46,38,0,state_university_of_new_york_at_stony_brook,accept,35
320,166,154,107.0,2.5,0,3,state_university_of_new_york_at_stony_brook,accept,35
317,159,158,102.0,3.04,29,0,state_university_of_new_york_at_stony_brook,accept,35
321,166,155,93.0,3.48,2,0,state_university_of_new_york_at_stony_brook,accept,35
316,166,150,94.0,3.09,6,0,state_university_of_new_york_at_stony_brook,accept,35
317,163,154,101.0,2.75,31,3,state_university_of_new_york_at_stony_brook,accept,35
317,166,151,102.0,3.5,13,0,state_university_of_new_york_at_stony_brook,accept,35
317,166,151,102.0,3.5,13,0,state_university_of_new_york_at_stony_brook,accept,35
324,169,155,99.0,3.24,18,0,state_university_of_new_york_at_stony_brook,accept,35
319,166,153,105.0,3.4,21,3,state_university_of_new_york_at_stony_brook,accept,35
318,161,157,113.0,3.5,33,2,state_university_of_new_york_at_stony_brook,accept,35
324,167,157,104.0,3.31,30,0,state_university_of_new_york_at_stony_brook,accept,35
319,167,152,75.0,2.5,13,0,state_university_of_new_york_at_stony_brook,accept,35
314,165,149,98.0,3.08,53,2,state_university_of_new_york_at_stony_brook,accept,35
310,161,149,106.0,3.14,60,0,state_university_of_new_york_at_stony_brook,accept,35
311,164,147,101,3.36,17,0,state_university_of_new_york_at_stony_brook,accept,35
321,164,157,104.0,3.52,10,3,state_university_of_new_york_at_stony_brook,accept,35
321,164,157,112.0,3.36,5,2,state_university_of_new_york_at_stony_brook,accept,35
313,163,150,106.0,3.53,0,0,state_university_of_new_york_at_stony_brook,accept,35
326,165,161,114.0,3.36,15,0,state_university_of_new_york_at_stony_brook,accept,35
318,164,154,106.0,2.82,6,0,state_university_of_new_york_at_stony_brook,accept,35
329,167,162,106.0,3.4,3,0,state_university_of_new_york_at_stony_brook,accept,35
309,163,146,96.0,3.48,12,0,state_university_of_new_york_at_stony_brook,accept,35
323,168,155,109.0,3.48,33,0,state_university_of_new_york_at_stony_brook,accept,35
323,168,155,109.0,3.48,33,0,state_university_of_new_york_at_stony_brook,accept,35
328,170,158,110.0,3.39,6,0,state_university_of_new_york_at_stony_brook,accept,35
315,166,149,99.0,3.64,0,0,state_university_of_new_york_at_stony_brook,accept,35
329,170,159,118.0,3.38,15,0,state_university_of_new_york_at_stony_brook,accept,35
313,164,149,75.0,3.35,21,2,state_university_of_new_york_at_stony_brook,accept,35
319,161,158,115.0,3.65,2,3,state_university_of_new_york_at_stony_brook,accept,35
323,170,153,106.0,2.8,5,0,state_university_of_new_york_at_stony_brook,accept,35
310,165,145,99.0,3.61,3,0,state_university_of_new_york_at_stony_brook,accept,35
325,168,157,111.0,3.75,16,0,state_university_of_new_york_at_stony_brook,accept,35
323,168,155,116.0,3.44,20,0,state_university_of_new_york_at_stony_brook,accept,35
322,163,159,110.0,3.52,32,0,state_university_of_new_york_at_stony_brook,accept,35
318,165,153,112.0,3.66,36,3,state_university_of_new_york_at_stony_brook,accept,35
319,167,152,102.0,3.68,45,0,state_university_of_new_york_at_stony_brook,accept,35
327,167,160,110.0,2.72,64,0,state_university_of_new_york_at_stony_brook,accept,35
326,168,158,110.0,2.92,60,0,state_university_of_new_york_at_stony_brook,accept,35
329,168,161,109.0,3.48,2,3,state_university_of_new_york_at_stony_brook,accept,35
317,166,151,96.0,3.64,6,0,state_university_of_new_york_at_stony_brook,accept,35
312,165,147,100.0,2.75,7,3,state_university_of_new_york_at_stony_brook,accept,35
314,164,150,103.0,3.56,17,3,state_university_of_new_york_at_stony_brook,accept,35
318,166,152,108.0,3.76,28,2,state_university_of_new_york_at_stony_brook,accept,35
325,169,156,114.0,3.69,34,3,state_university_of_new_york_at_stony_brook,accept,35
319,166,153,107.0,3.37,0,0,state_university_of_new_york_at_stony_brook,accept,35
317,159,158,113.0,3.66,30,1,state_university_of_new_york_at_stony_brook,accept,35
318,170,148,103.0,2.98,20,0,state_university_of_new_york_at_stony_brook,accept,35
328,169,159,109.0,3.26,9,2,state_university_of_new_york_at_stony_brook,accept,35
325,167,158,112.0,3.62,5,0,state_university_of_new_york_at_stony_brook,accept,35
325,168,157,113.0,3.72,9,0,state_university_of_new_york_at_stony_brook,accept,35
326,166,160,117.0,2.8,6,0,state_university_of_new_york_at_stony_brook,accept,35
330,169,161,105.0,3.75,3,3,state_university_of_new_york_at_stony_brook,accept,35
319,162,157,110.0,3.69,34,3,state_university_of_new_york_at_stony_brook,accept,35
325,168,157,113.0,2.62,39,3,state_university_of_new_york_at_stony_brook,accept,35
322,164,158,107.0,3.51,0,0,state_university_of_new_york_at_stony_brook,accept,35
323,166,157,106.0,3.64,19,0,state_university_of_new_york_at_stony_brook,accept,35
322,170,152,105.0,3.17,25,2,state_university_of_new_york_at_stony_brook,accept,35
318,168,150,100.0,3.08,14,0,state_university_of_new_york_at_stony_brook,accept,35
323,168,155,106.0,3.26,19,3,state_university_of_new_york_at_stony_brook,accept,35
323,168,155,110.0,3.32,9,0,state_university_of_new_york_at_stony_brook,accept,35
320,169,151,102.0,3.37,9,3,state_university_of_new_york_at_stony_brook,accept,35
332,170,162,114.0,3.28,32,2,state_university_of_new_york_at_stony_brook,accept,35
321,169,152,107.0,3.7,27,0,state_university_of_new_york_at_stony_brook,accept,35
314,163,151,104.0,3.9,26,2,state_university_of_new_york_at_stony_brook,accept,35
327,169,158,108.0,3.28,29,0,state_university_of_new_york_at_stony_brook,accept,35
312,165,147,0,3.28,0,0,state_university_of_new_york_at_stony_brook,accept,35
324,169,155,105.0,3.65,6,3,state_university_of_new_york_at_stony_brook,accept,35
326,170,156,116.0,3.52,3,0,state_university_of_new_york_at_stony_brook,accept,35
329,170,159,110.0,3.52,60,0,state_university_of_new_york_at_stony_brook,accept,35
324,167,157,103.0,3.32,46,0,state_university_of_new_york_at_stony_brook,accept,35
324,167,157,103.0,3.32,46,0,state_university_of_new_york_at_stony_brook,accept,35
322,166,156,110.0,3.46,18,3,state_university_of_new_york_at_stony_brook,accept,35
319,166,153,103.0,2.86,40,0,state_university_of_new_york_at_stony_brook,accept,35
324,158,166,109.0,3.36,0,0,state_university_of_new_york_at_stony_brook,accept,35
320,166,154,116.0,3.88,32,3,state_university_of_new_york_at_stony_brook,accept,35
319,166,153,109.0,3.19,27,0,state_university_of_new_york_at_stony_brook,accept,35
324,170,154,100.0,3.37,37,0,state_university_of_new_york_at_stony_brook,accept,35
313,169,144,105.0,3.48,1,3,state_university_of_new_york_at_stony_brook,accept,35
317,167,150,101,3.47,32,0,state_university_of_new_york_at_stony_brook,accept,35
324,169,155,104.0,2.89,43,0,state_university_of_new_york_at_stony_brook,accept,35
323,168,155,116.0,3.52,25,0,state_university_of_new_york_at_stony_brook,accept,35
327,170,157,104.0,3.53,18,0,state_university_of_new_york_at_stony_brook,accept,35
327,165,162,117.0,3.28,17,0,state_university_of_new_york_at_stony_brook,accept,35
321,168,153,97.0,3.12,3,0,state_university_of_new_york_at_stony_brook,accept,35
311,160,151,101.0,3.66,18,3,state_university_of_new_york_at_stony_brook,accept,35
313,161,152,117.0,3.63,32,3,state_university_of_new_york_at_stony_brook,accept,35
325,167,158,115.0,3.74,20,0,state_university_of_new_york_at_stony_brook,accept,35
325,167,158,115.0,3.74,20,0,state_university_of_new_york_at_stony_brook,accept,35
320,161,159,113.0,2.7,82,0,state_university_of_new_york_at_stony_brook,accept,35
324,168,156,111.0,3.3,26,2,state_university_of_new_york_at_stony_brook,accept,35
325,167,158,114.0,3.48,1,0,state_university_of_new_york_at_stony_brook,accept,35
333,170,163,112.0,3.34,52,0,state_university_of_new_york_at_stony_brook,accept,35
319,165,154,104.0,3.66,15,0,state_university_of_new_york_at_stony_brook,accept,35
322,167,155,113.0,3.76,16,3,state_university_of_new_york_at_stony_brook,accept,35
317,168,149,106.0,2.83,15,0,state_university_of_new_york_at_stony_brook,accept,35
328,158,170,114.0,3.48,20,3,state_university_of_new_york_at_stony_brook,accept,35
320,168,152,99.0,3.3,25,3,state_university_of_new_york_at_stony_brook,accept,35
318,167,151,100.0,2.72,30,0,state_university_of_new_york_at_stony_brook,accept,35
316,165,151,104.0,3.68,20,3,state_university_of_new_york_at_stony_brook,accept,35
327,170,157,114,3.04,18,0,state_university_of_new_york_at_stony_brook,accept,35
325,166,159,118.0,3.54,6,3,state_university_of_new_york_at_stony_brook,accept,35
325,168,157,114.0,2.96,27,0,state_university_of_new_york_at_stony_brook,accept,35
321,167,154,115.0,3.55,23,0,state_university_of_new_york_at_stony_brook,accept,35
323,168,155,100.0,3.46,29,3,state_university_of_new_york_at_stony_brook,accept,35
323,168,155,100.0,3.46,29,3,state_university_of_new_york_at_stony_brook,accept,35
323,167,156,75.0,3.55,1,3,state_university_of_new_york_at_stony_brook,accept,35
324,170,154,106.0,3.44,10,0,state_university_of_new_york_at_stony_brook,accept,35
318,163,155,110.0,3.37,48,0,state_university_of_new_york_at_stony_brook,accept,35
330,168,162,117.0,3.5,18,0,state_university_of_new_york_at_stony_brook,accept,35
310,149,161,91.0,3.2,0,0,state_university_of_new_york_at_stony_brook,accept,35
322,155,167,109.0,3.0,20,3,state_university_of_new_york_at_stony_brook,accept,35
314,163,151,104.0,3.75,15,3,state_university_of_new_york_at_stony_brook,accept,35
321,169,152,103.0,3.53,1,3,state_university_of_new_york_at_stony_brook,accept,35
318,166,152,117.0,3.66,0,0,state_university_of_new_york_at_stony_brook,accept,35
332,170,162,114.0,3.4,24,0,state_university_of_new_york_at_stony_brook,accept,35
332,169,163,116.0,3.16,2,0,state_university_of_new_york_at_stony_brook,accept,35
317,168,149,114,3.88,5,0,state_university_of_new_york_at_stony_brook,accept,35
316,167,149,107.0,3.6,27,0,state_university_of_new_york_at_stony_brook,accept,35
325,169,156,115.0,3.67,15,0,state_university_of_new_york_at_stony_brook,accept,35
311,164,147,99.0,3.46,17,0,state_university_of_new_york_at_stony_brook,accept,35
323,163,160,118.0,3.72,1,3,state_university_of_new_york_at_stony_brook,accept,35
320,164,156,105.0,3.05,28,0,state_university_of_new_york_at_stony_brook,accept,35
313,164,149,104.0,3.8,42,0,state_university_of_new_york_at_stony_brook,accept,35
317,166,151,95.0,2.89,20,0,state_university_of_new_york_at_stony_brook,accept,35
316,163,153,106.0,3.88,6,0,state_university_of_new_york_at_stony_brook,accept,35
326,169,157,111.0,3.26,1,3,state_university_of_new_york_at_stony_brook,accept,35
317,162,155,112.0,3.6,27,3,state_university_of_new_york_at_stony_brook,accept,35
316,163,153,105.0,3.91,39,0,state_university_of_new_york_at_stony_brook,accept,35
321,164,157,106.0,3.65,29,3,state_university_of_new_york_at_stony_brook,accept,35
321,167,154,0,3.6,6,0,state_university_of_new_york_at_stony_brook,accept,35
319,169,150,106.0,3.56,29,0,state_university_of_new_york_at_stony_brook,accept,35
315,166,149,105.0,2.72,29,0,state_university_of_new_york_at_stony_brook,accept,35
333,168,165,114.0,3.61,2,0,state_university_of_new_york_at_stony_brook,accept,35
315,167,148,103.0,3.62,21,0,state_university_of_new_york_at_stony_brook,accept,35
317,162,155,111.0,3.65,2,0,state_university_of_new_york_at_stony_brook,accept,35
319,163,156,111.0,3.52,90,0,state_university_of_new_york_at_stony_brook,accept,35
315,160,155,113.0,3.65,6,2,state_university_of_new_york_at_stony_brook,accept,35
322,165,157,113.0,3.15,44,0,state_university_of_new_york_at_stony_brook,accept,35
333,168,165,114.0,3.82,0,0,state_university_of_new_york_at_stony_brook,accept,35
326,169,157,111.0,3.4,0,0,state_university_of_new_york_at_stony_brook,accept,35
325,168,157,106.0,2.65,8,3,state_university_of_new_york_at_stony_brook,accept,35
325,170,155,110.0,3.44,33,0,state_university_of_new_york_at_stony_brook,accept,35
320,166,154,109.0,3.92,8,3,state_university_of_new_york_at_stony_brook,accept,35
321,166,155,112.0,3.8,43,3,state_university_of_new_york_at_stony_brook,accept,35
319,163,156,105.0,3.41,27,0,state_university_of_new_york_at_stony_brook,accept,35
325,170,155,115.0,3.48,5,0,state_university_of_new_york_at_stony_brook,accept,35
322,168,154,108.0,3.56,20,0,state_university_of_new_york_at_stony_brook,accept,35
312,162,150,106.0,3.48,32,3,state_university_of_new_york_at_stony_brook,accept,35
327,170,157,110.0,3.42,32,0,state_university_of_new_york_at_stony_brook,accept,35
315,164,151,108.0,3.62,1,0,state_university_of_new_york_at_stony_brook,accept,35
328,164,164,116.0,3.64,0,0,state_university_of_new_york_at_stony_brook,accept,35
330,170,160,114.0,3.04,6,3,state_university_of_new_york_at_stony_brook,accept,35
314,162,152,105.0,3.8,18,0,state_university_of_new_york_at_stony_brook,accept,35
314,162,152,105.0,3.8,18,0,state_university_of_new_york_at_stony_brook,accept,35
315,166,149,101,3.65,30,2,state_university_of_new_york_at_stony_brook,accept,35
312,158,154,102.0,3.65,42,0,state_university_of_new_york_at_stony_brook,accept,35
319,165,154,101.0,3.0,52,0,state_university_of_new_york_at_stony_brook,accept,35
309,159,150,93.0,3.58,44,0,state_university_of_new_york_at_stony_brook,accept,35
318,168,150,75.0,3.87,5,0,state_university_of_new_york_at_stony_brook,accept,35
324,165,159,116.0,3.78,22,0,state_university_of_new_york_at_stony_brook,accept,35
321,170,151,75.0,2.99,27,0,state_university_of_new_york_at_stony_brook,accept,35
330,166,164,117.0,3.55,40,0,state_university_of_new_york_at_stony_brook,accept,35
324,164,160,108.0,3.34,26,0,state_university_of_new_york_at_stony_brook,accept,35
324,166,158,109.0,3.26,29,3,state_university_of_new_york_at_stony_brook,accept,35
318,165,153,103.0,3.44,27,0,state_university_of_new_york_at_stony_brook,accept,35
322,166,156,103.0,3.23,28,0,state_university_of_new_york_at_stony_brook,accept,35
310,165,145,101,3.69,15,0,state_university_of_new_york_at_stony_brook,accept,35
330,167,163,114.0,2.4,6,0,state_university_of_new_york_at_stony_brook,accept,35
328,165,163,113.0,3.75,22,0,state_university_of_new_york_at_stony_brook,accept,35
328,165,163,113.0,3.75,22,0,state_university_of_new_york_at_stony_brook,accept,35
315,166,149,99.0,3.08,12,0,state_university_of_new_york_at_stony_brook,accept,35
319,170,149,108.0,2.64,42,0,state_university_of_new_york_at_stony_brook,accept,35
312,162,150,106.0,3.0,40,0,state_university_of_new_york_at_stony_brook,accept,35
308,160,148,96.0,3.28,98,0,state_university_of_new_york_at_stony_brook,accept,35
317,164,153,101.0,3.71,50,0,state_university_of_new_york_at_stony_brook,accept,35
315,168,147,102.0,3.04,35,0,state_university_of_new_york_at_stony_brook,accept,35
307,163,144,93.0,3.2,1,0,state_university_of_new_york_at_stony_brook,accept,35
307,165,142,93.0,3.33,29,0,state_university_of_new_york_at_stony_brook,accept,35
323,165,158,75.0,3.58,40,3,state_university_of_new_york_at_stony_brook,accept,35
312,165,147,88.0,3.14,50,3,state_university_of_new_york_at_stony_brook,accept,35
317,169,148,93.0,3.06,60,0,state_university_of_new_york_at_stony_brook,accept,35
316,166,150,104.0,3.05,40,0,state_university_of_new_york_at_stony_brook,accept,35
318,165,153,102.0,3.57,38,0,state_university_of_new_york_at_stony_brook,accept,35
333,168,165,118.0,3.54,6,0,state_university_of_new_york_at_stony_brook,accept,35
329,168,161,113.0,3.06,40,0,state_university_of_new_york_at_stony_brook,accept,35
315,166,149,99.0,3.31,36,3,state_university_of_new_york_at_stony_brook,accept,35
319,166,153,112.0,3.42,36,0,state_university_of_new_york_at_stony_brook,accept,35
321,164,157,106.0,3.21,14,0,state_university_of_new_york_at_stony_brook,accept,35
321,166,155,109.0,3.64,1,3,state_university_of_new_york_at_stony_brook,accept,35
317,164,153,101,2.7,86,0,state_university_of_new_york_at_stony_brook,accept,35
320,165,155,113.0,3.44,10,0,state_university_of_new_york_at_stony_brook,accept,35
320,168,152,103.0,3.62,12,3,state_university_of_new_york_at_stony_brook,accept,35
324,168,156,111.0,3.32,24,0,state_university_of_new_york_at_stony_brook,accept,35
312,163,149,0,3.61,6,0,state_university_of_new_york_at_stony_brook,accept,35
316,169,147,107.0,2.84,40,0,state_university_of_new_york_at_stony_brook,accept,35
335,168,167,117.0,3.68,2,3,state_university_of_new_york_at_stony_brook,accept,35
321,169,152,102.0,2.97,18,0,state_university_of_new_york_at_stony_brook,accept,35
315,163,152,102.0,3.28,16,0,state_university_of_new_york_at_stony_brook,accept,35
327,169,158,109.0,3.46,40,0,state_university_of_new_york_at_stony_brook,accept,35
318,168,150,0,3.0,24,3,state_university_of_new_york_at_stony_brook,accept,35
327,170,157,116.0,3.68,6,0,state_university_of_new_york_at_stony_brook,accept,35
325,168,157,0,3.73,0,0,state_university_of_new_york_at_stony_brook,accept,35
314,167,147,91.0,3.48,28,2,state_university_of_new_york_at_stony_brook,accept,35
312,164,148,97.0,3.65,27,3,state_university_of_new_york_at_stony_brook,accept,35
322,168,154,104.0,3.36,50,0,state_university_of_new_york_at_stony_brook,accept,35
322,170,152,109.0,3.02,44,3,state_university_of_new_york_at_stony_brook,accept,35
316,163,153,103.0,2.65,21,0,state_university_of_new_york_at_stony_brook,reject,35
316,163,153,103.0,2.65,21,0,state_university_of_new_york_at_stony_brook,reject,35
321,168,153,103.0,3.52,6,3,state_university_of_new_york_at_stony_brook,reject,35
318,167,151,98.0,3.2,6,0,state_university_of_new_york_at_stony_brook,reject,35
320,163,157,113.0,3.77,0,2,state_university_of_new_york_at_stony_brook,reject,35
312,163,149,100.0,2.88,27,0,state_university_of_new_york_at_stony_brook,reject,35
315,164,151,105.0,3.65,20,2,state_university_of_new_york_at_stony_brook,reject,35
317,159,158,114.0,3.52,4,1,state_university_of_new_york_at_stony_brook,reject,35
312,163,149,109.0,3.08,60,0,state_university_of_new_york_at_stony_brook,reject,35
324,165,159,113.0,2.51,28,0,state_university_of_new_york_at_stony_brook,reject,35
322,165,157,75.0,3.2,23,0,state_university_of_new_york_at_stony_brook,reject,35
317,164,153,108.0,3.22,32,0,state_university_of_new_york_at_stony_brook,reject,35
318,160,158,114,3.29,18,0,state_university_of_new_york_at_stony_brook,reject,35
309,159,150,92.0,3.06,22,0,state_university_of_new_york_at_stony_brook,reject,35
310,161,149,101,3.34,17,0,state_university_of_new_york_at_stony_brook,reject,35
311,166,145,75.0,3.07,50,0,state_university_of_new_york_at_stony_brook,reject,35
318,164,154,99.0,3.12,12,0,state_university_of_new_york_at_stony_brook,reject,35
316,163,153,103.0,2.65,21,0,state_university_of_new_york_at_stony_brook,reject,35
316,163,153,103.0,2.65,21,0,state_university_of_new_york_at_stony_brook,reject,35
330,169,161,115.0,3.03,0,0,state_university_of_new_york_at_stony_brook,reject,35
318,167,151,98.0,3.2,6,0,state_university_of_new_york_at_stony_brook,reject,35
320,163,157,113.0,3.77,0,2,state_university_of_new_york_at_stony_brook,reject,35
312,163,149,100.0,2.88,27,0,state_university_of_new_york_at_stony_brook,reject,35
320,165,155,107.0,2.93,29,0,state_university_of_new_york_at_stony_brook,reject,35
317,159,158,114.0,3.52,4,1,state_university_of_new_york_at_stony_brook,reject,35
312,163,149,109.0,3.08,60,0,state_university_of_new_york_at_stony_brook,reject,35
324,165,159,113.0,2.51,28,0,state_university_of_new_york_at_stony_brook,reject,35
308,165,143,96.0,2.2,92,0,state_university_of_new_york_at_stony_brook,reject,35
317,164,153,108.0,3.22,32,0,state_university_of_new_york_at_stony_brook,reject,35
318,160,158,114,3.29,18,0,state_university_of_new_york_at_stony_brook,reject,35
309,159,150,92.0,3.06,22,0,state_university_of_new_york_at_stony_brook,reject,35
310,164,146,96.0,2.42,13,0,state_university_of_new_york_at_stony_brook,reject,35
311,166,145,75.0,3.07,50,0,state_university_of_new_york_at_stony_brook,reject,35
318,164,154,99.0,3.12,12,0,state_university_of_new_york_at_stony_brook,reject,35
321,167,154,102.0,3.44,24,0,state_university_of_new_york_at_stony_brook,reject,35
322,164,158,115.0,3.64,20,1,state_university_of_new_york_at_stony_brook,reject,35
317,167,150,110.0,3.76,13,0,state_university_of_new_york_at_stony_brook,reject,35
320,167,153,108.0,3.03,0,1,state_university_of_new_york_at_stony_brook,reject,35
318,167,151,113.0,3.14,3,0,state_university_of_new_york_at_stony_brook,reject,35
311,161,150,105.0,3.1,8,0,state_university_of_new_york_at_stony_brook,reject,35
323,157,166,101.0,3.36,27,0,state_university_of_new_york_at_stony_brook,reject,35
320,167,153,108.0,2.5,36,0,state_university_of_new_york_at_stony_brook,reject,35
319,165,154,99.0,2.87,30,2,state_university_of_new_york_at_stony_brook,reject,35
308,163,145,105.0,3.55,48,0,state_university_of_new_york_at_stony_brook,reject,35
318,163,155,109.0,2.4,49,0,state_university_of_new_york_at_stony_brook,reject,35
326,165,161,103.0,2.53,0,3,state_university_of_new_york_at_stony_brook,reject,35
328,169,159,106.0,2.84,30,0,state_university_of_new_york_at_stony_brook,reject,35
325,168,157,108.0,3.42,25,2,state_university_of_new_york_at_stony_brook,reject,35
319,168,151,111.0,3.28,18,0,state_university_of_new_york_at_stony_brook,reject,35
315,162,153,100.0,2.92,28,3,state_university_of_new_york_at_stony_brook,reject,35
314,164,150,106.0,3.66,15,3,state_university_of_new_york_at_stony_brook,reject,35
326,165,161,110.0,2.69,30,0,state_university_of_new_york_at_stony_brook,reject,35
314,165,149,105.0,3.51,25,0,state_university_of_new_york_at_stony_brook,reject,35
312,167,145,100.0,2.8,21,0,state_university_of_new_york_at_stony_brook,reject,35
323,164,159,110.0,3.12,12,0,state_university_of_new_york_at_stony_brook,reject,35
312,165,147,92.0,3.51,20,2,state_university_of_new_york_at_stony_brook,reject,35
313,164,149,108.0,2.35,21,0,state_university_of_new_york_at_stony_brook,reject,35
327,169,158,106.0,2.84,41,0,state_university_of_new_york_at_stony_brook,reject,35
329,167,162,106.0,3.08,23,0,state_university_of_new_york_at_stony_brook,reject,35
329,167,162,112.0,3.48,14,3,state_university_of_new_york_at_stony_brook,reject,35
324,169,155,115.0,3.33,19,0,state_university_of_new_york_at_stony_brook,reject,35
314,160,154,107.0,2.99,24,0,state_university_of_new_york_at_stony_brook,reject,35
317,163,154,114,2.84,20,0,state_university_of_new_york_at_stony_brook,reject,35
317,167,150,108.0,3.43,2,0,state_university_of_new_york_at_stony_brook,reject,35
312,161,151,102.0,3.27,27,0,state_university_of_new_york_at_stony_brook,reject,35
317,167,150,101.0,3.18,0,0,state_university_of_new_york_at_stony_brook,reject,35
317,167,150,101.0,3.18,0,0,state_university_of_new_york_at_stony_brook,reject,35
310,161,149,97.0,2.65,2,0,state_university_of_new_york_at_stony_brook,reject,35
318,160,158,112.0,2.31,5,3,state_university_of_new_york_at_stony_brook,reject,35
324,167,157,103.0,3.65,5,0,state_university_of_new_york_at_stony_brook,reject,35
319,168,151,95.0,3.67,20,0,state_university_of_new_york_at_stony_brook,reject,35
327,166,161,113.0,3.29,14,0,state_university_of_new_york_at_stony_brook,reject,35
318,163,155,113.0,3.0,0,0,state_university_of_new_york_at_stony_brook,reject,35
310,159,151,108.0,2.45,112,0,state_university_of_new_york_at_stony_brook,reject,35
320,167,153,109.0,2.63,18,0,state_university_of_new_york_at_stony_brook,reject,35
322,161,161,114.0,3.19,7,0,state_university_of_new_york_at_stony_brook,reject,35
316,160,156,112.0,3.23,27,0,state_university_of_new_york_at_stony_brook,reject,35
310,159,151,101.0,3.4,6,3,state_university_of_new_york_at_stony_brook,reject,35
320,166,154,105.0,3.74,0,0,state_university_of_new_york_at_stony_brook,reject,35
325,170,155,103.0,2.84,30,0,state_university_of_new_york_at_stony_brook,reject,35
321,170,151,103.0,3.6,6,3,state_university_of_new_york_at_stony_brook,reject,35
316,164,152,103.0,3.4,30,0,state_university_of_new_york_at_stony_brook,reject,35
316,164,152,103.0,3.4,30,0,state_university_of_new_york_at_stony_brook,reject,35
314,164,150,110.0,3.55,25,3,state_university_of_new_york_at_stony_brook,reject,35
301,159,142,93.0,3.36,30,0,state_university_of_new_york_at_stony_brook,reject,35
328,170,158,114.0,3.4,15,0,state_university_of_new_york_at_stony_brook,reject,35
326,170,156,120.0,3.07,20,3,state_university_of_new_york_at_stony_brook,reject,35
321,166,155,114.0,3.6,5,0,state_university_of_new_york_at_stony_brook,reject,35
323,169,154,114,3.34,0,0,state_university_of_new_york_at_stony_brook,reject,35
322,167,155,75.0,2.45,0,0,state_university_of_new_york_at_stony_brook,reject,35
324,162,162,109.0,3.4,19,0,state_university_of_new_york_at_stony_brook,reject,35
319,160,159,114,3.52,17,3,state_university_of_new_york_at_stony_brook,reject,35
323,170,153,111.0,3.56,3,0,state_university_of_new_york_at_stony_brook,reject,35
323,170,153,108.0,3.37,14,0,state_university_of_new_york_at_stony_brook,reject,35
318,163,155,108.0,2.35,6,2,state_university_of_new_york_at_stony_brook,reject,35
295,155,140,92.0,2.23,43,0,state_university_of_new_york_at_stony_brook,reject,35
317,164,153,106.0,3.0,53,3,state_university_of_new_york_at_stony_brook,reject,35
320,168,152,100.0,3.0,40,0,state_university_of_new_york_at_stony_brook,reject,35
325,168,157,105.0,2.95,28,0,state_university_of_new_york_at_stony_brook,reject,35
325,168,157,105.0,2.95,28,0,state_university_of_new_york_at_stony_brook,reject,35
323,165,158,111.0,2.67,0,0,state_university_of_new_york_at_stony_brook,reject,35
312,155,157,114.0,2.81,27,0,state_university_of_new_york_at_stony_brook,reject,35
324,168,156,105.0,2.84,20,0,state_university_of_new_york_at_stony_brook,reject,35
321,166,155,115.0,3.18,28,0,state_university_of_new_york_at_stony_brook,reject,35
319,163,156,113.0,3.44,10,0,state_university_of_new_york_at_stony_brook,reject,35
316,161,155,114,3.26,8,2,state_university_of_new_york_at_stony_brook,reject,35
318,169,149,102.0,3.4,0,0,state_university_of_new_york_at_stony_brook,reject,35
308,159,149,104.0,3.74,10,0,state_university_of_new_york_at_stony_brook,reject,35
313,165,148,92.0,3.1,28,3,state_university_of_new_york_at_stony_brook,reject,35
327,167,160,117.0,3.67,6,0,state_university_of_new_york_at_stony_brook,reject,35
326,166,160,117.0,3.14,15,0,state_university_of_new_york_at_stony_brook,reject,35
314,163,151,98.0,3.12,18,0,state_university_of_new_york_at_stony_brook,reject,35
308,161,147,84.0,3.28,27,0,state_university_of_new_york_at_stony_brook,reject,35
320,166,154,102.0,3.52,13,3,state_university_of_new_york_at_stony_brook,reject,35
325,164,161,111.0,3.32,18,2,state_university_of_new_york_at_stony_brook,reject,35
316,162,154,110.0,3.64,21,0,state_university_of_new_york_at_stony_brook,reject,35
314,159,155,108.0,3.48,28,3,state_university_of_new_york_at_stony_brook,reject,35
308,158,150,101,3.16,0,0,state_university_of_new_york_at_stony_brook,reject,35
321,164,157,105.0,2.65,9,1,state_university_of_new_york_at_stony_brook,reject,35
312,165,147,91.0,2.6,60,0,state_university_of_new_york_at_stony_brook,reject,35
305,153,152,111.0,3.0,1,0,state_university_of_new_york_at_stony_brook,reject,35
321,165,156,106.0,3.46,16,3,state_university_of_new_york_at_stony_brook,reject,35
318,162,156,104.0,3.36,33,0,state_university_of_new_york_at_stony_brook,reject,35
314,159,155,100.0,3.53,33,0,state_university_of_new_york_at_stony_brook,reject,35
322,170,152,110.0,3.64,3,0,state_university_of_new_york_at_stony_brook,reject,35
322,166,156,100.0,3.06,18,0,state_university_of_new_york_at_stony_brook,reject,35
317,162,155,102.0,2.65,49,0,state_university_of_new_york_at_stony_brook,reject,35
308,159,149,89.0,2.75,24,2,state_university_of_new_york_at_stony_brook,reject,35
302,159,143,99.0,2.81,17,0,state_university_of_new_york_at_stony_brook,reject,35
312,157,155,118.0,3.44,20,3,state_university_of_new_york_at_stony_brook,reject,35
314,162,152,102.0,3.51,38,0,state_university_of_new_york_at_stony_brook,reject,35
320,170,150,75.0,3.4,2,0,state_university_of_new_york_at_stony_brook,reject,35
318,162,156,114,3.46,2,0,state_university_of_new_york_at_stony_brook,reject,35
318,166,152,104.0,3.47,9,3,state_university_of_new_york_at_stony_brook,reject,35
319,169,150,109.0,3.19,24,3,state_university_of_new_york_at_stony_brook,reject,35
314,166,148,114.0,3.54,3,0,state_university_of_new_york_at_stony_brook,reject,35
324,164,160,109.0,3.2,15,0,state_university_of_new_york_at_stony_brook,reject,35
323,165,158,110.0,3.6,31,2,state_university_of_new_york_at_stony_brook,reject,35
310,163,147,98.0,2.25,46,3,state_university_of_new_york_at_stony_brook,reject,35
313,162,151,95.0,3.2,0,0,state_university_of_new_york_at_stony_brook,reject,35
317,169,148,100.0,3.36,31,0,state_university_of_new_york_at_stony_brook,reject,35
312,160,152,108.0,3.34,35,0,state_university_of_new_york_at_stony_brook,reject,35
313,165,148,102.0,2.64,30,3,state_university_of_new_york_at_stony_brook,reject,35
313,158,155,110.0,2.15,6,0,state_university_of_new_york_at_stony_brook,reject,35
315,163,152,102.0,3.1,8,0,state_university_of_new_york_at_stony_brook,reject,35
322,170,152,107.0,3.08,8,0,state_university_of_new_york_at_stony_brook,reject,35
316,161,155,111.0,2.55,32,0,state_university_of_new_york_at_stony_brook,reject,35
309,159,150,97.0,2.75,31,0,state_university_of_new_york_at_stony_brook,reject,35
309,159,150,97.0,2.75,31,0,state_university_of_new_york_at_stony_brook,reject,35
306,159,147,99.0,3.0,0,0,state_university_of_new_york_at_stony_brook,reject,35
317,162,155,111.0,3.24,1,0,state_university_of_new_york_at_stony_brook,reject,35
319,167,152,103.0,2.59,21,3,state_university_of_new_york_at_stony_brook,reject,35
318,162,156,108.0,3.8,20,3,state_university_of_new_york_at_stony_brook,reject,35
322,168,154,101.0,3.11,27,0,state_university_of_new_york_at_stony_brook,reject,35
331,165,166,115.0,2.35,46,0,state_university_of_new_york_at_stony_brook,reject,35
332,167,165,111.0,2.6,19,0,state_university_of_new_york_at_stony_brook,reject,35
307,158,149,98.0,3.56,55,3,state_university_of_new_york_at_stony_brook,reject,35
320,163,157,108.0,3.32,26,0,state_university_of_new_york_at_stony_brook,reject,35
321,168,153,111.0,3.3,20,3,state_university_of_new_york_at_stony_brook,reject,35
323,161,162,106.0,2.75,39,0,state_university_of_new_york_at_stony_brook,reject,35
310,161,149,101,3.3,6,0,state_university_of_new_york_at_stony_brook,reject,35
320,166,154,102.0,3.42,22,0,state_university_of_new_york_at_stony_brook,reject,35
326,170,156,110.0,2.92,0,0,state_university_of_new_york_at_stony_brook,reject,35
311,163,148,105.0,1.25,0,0,state_university_of_new_york_at_stony_brook,reject,35
315,165,150,98.0,3.76,6,3,state_university_of_new_york_at_stony_brook,reject,35
315,165,150,98.0,3.76,6,3,state_university_of_new_york_at_stony_brook,reject,35
310,161,149,96.0,3.55,55,3,state_university_of_new_york_at_stony_brook,reject,35
305,160,145,98.0,2.68,1,3,state_university_of_new_york_at_stony_brook,reject,35
318,164,154,109.0,3.02,15,0,state_university_of_new_york_at_stony_brook,reject,35
316,166,150,102.0,3.51,0,0,state_university_of_new_york_at_stony_brook,reject,35
315,162,153,99.0,2.94,2,0,state_university_of_new_york_at_stony_brook,reject,35
316,166,150,108.0,2.8,16,0,state_university_of_new_york_at_stony_brook,reject,35
321,166,155,114,2.6,16,0,state_university_of_new_york_at_stony_brook,reject,35
311,156,155,104.0,3.04,1,3,state_university_of_new_york_at_stony_brook,reject,35
313,160,153,104.0,3.11,42,0,state_university_of_new_york_at_stony_brook,reject,35
322,167,155,103.0,2.92,23,0,state_university_of_new_york_at_stony_brook,reject,35
316,164,152,108.0,3.23,30,3,state_university_of_new_york_at_stony_brook,reject,35
311,167,144,93.0,3.37,20,0,state_university_of_new_york_at_stony_brook,reject,35
312,160,152,104.0,3.19,0,0,state_university_of_new_york_at_stony_brook,reject,35
320,167,153,106.0,2.98,32,3,state_university_of_new_york_at_stony_brook,reject,35
319,168,151,106.0,3.4,16,0,state_university_of_new_york_at_stony_brook,reject,35
319,168,151,106.0,3.4,16,0,state_university_of_new_york_at_stony_brook,reject,35
319,164,155,104.0,3.35,5,3,state_university_of_new_york_at_stony_brook,reject,35
315,168,147,105.0,2.54,21,2,state_university_of_new_york_at_stony_brook,reject,35
307,161,146,91.0,3.2,18,0,state_university_of_new_york_at_stony_brook,reject,35
315,163,152,113.0,2.75,43,0,state_university_of_new_york_at_stony_brook,reject,35
310,161,149,102.0,2.79,31,3,state_university_of_new_york_at_stony_brook,reject,35
319,166,153,110.0,3.41,38,3,state_university_of_new_york_at_stony_brook,reject,35
310,161,149,101.0,2.5,27,0,state_university_of_new_york_at_stony_brook,reject,35
310,161,149,95.0,3.0,30,0,state_university_of_new_york_at_stony_brook,reject,35
314,168,146,109.0,3.26,13,0,state_university_of_new_york_at_stony_brook,reject,35
316,162,154,93.0,3.02,33,3,state_university_of_new_york_at_stony_brook,reject,35
321,169,152,99.0,2.49,18,0,state_university_of_new_york_at_stony_brook,reject,35
306,158,148,93.0,3.52,0,0,state_university_of_new_york_at_stony_brook,reject,35
314,164,150,103.0,3.2,3,1,state_university_of_new_york_at_stony_brook,reject,35
321,170,151,101.0,3.52,7,0,state_university_of_new_york_at_stony_brook,reject,35
317,169,148,75.0,2.88,26,2,state_university_of_new_york_at_stony_brook,reject,35
319,164,155,108.0,3.28,30,0,state_university_of_new_york_at_stony_brook,reject,35
314,168,146,103.0,3.26,24,0,state_university_of_new_york_at_stony_brook,reject,35
311,162,149,101.0,2.33,25,0,state_university_of_new_york_at_stony_brook,reject,35
320,168,152,98.0,2.88,4,0,state_university_of_new_york_at_stony_brook,reject,35
308,166,142,100.0,2.98,39,0,state_university_of_new_york_at_stony_brook,reject,35
317,165,152,113.0,3.64,6,0,state_university_of_new_york_at_stony_brook,reject,35
325,168,157,113.0,3.27,1,2,state_university_of_new_york_at_stony_brook,reject,35
308,162,146,94.0,3.2,20,0,state_university_of_new_york_at_stony_brook,reject,35
313,165,148,94.0,3.53,41,0,state_university_of_new_york_at_stony_brook,reject,35
317,163,154,103.0,3.48,12,3,state_university_of_new_york_at_stony_brook,reject,35
324,169,155,113.0,3.25,5,0,state_university_of_new_york_at_stony_brook,reject,35
314,165,149,105.0,3.49,19,0,state_university_of_new_york_at_stony_brook,reject,35
318,168,150,110.0,3.33,0,0,state_university_of_new_york_at_stony_brook,reject,35
322,166,156,106.0,3.0,21,0,state_university_of_new_york_at_stony_brook,reject,35
319,168,151,106.0,2.05,38,0,state_university_of_new_york_at_stony_brook,reject,35
315,166,149,95.0,3.52,0,0,state_university_of_new_york_at_stony_brook,reject,35
324,164,160,112.0,3.44,39,0,state_university_of_new_york_at_stony_brook,reject,35
310,164,146,100.0,3.36,48,0,state_university_of_new_york_at_stony_brook,reject,35
312,165,147,65.0,3.5,30,3,state_university_of_new_york_at_stony_brook,reject,35
315,165,150,97.0,3.53,24,0,state_university_of_new_york_at_stony_brook,reject,35
314,164,150,102.0,2.67,15,0,state_university_of_new_york_at_stony_brook,reject,35
327,169,158,107.0,3.45,31,0,state_university_of_new_york_at_stony_brook,reject,35
325,165,160,110.0,3.06,24,3,state_university_of_new_york_at_stony_brook,reject,35
317,163,154,108.0,3.52,28,0,state_university_of_new_york_at_stony_brook,reject,35
314,167,147,101,3.3,4,0,state_university_of_new_york_at_stony_brook,reject,35
324,168,156,114.0,3.02,11,2,state_university_of_new_york_at_stony_brook,reject,35
318,166,152,103.0,3.14,17,0,state_university_of_new_york_at_stony_brook,reject,35
301,150,151,89.0,3.2,50,0,state_university_of_new_york_at_stony_brook,reject,35
314,164,150,103.0,3.64,1,3,state_university_of_new_york_at_stony_brook,reject,35
312,165,147,107.0,2.96,30,3,state_university_of_new_york_at_stony_brook,reject,35
320,167,153,75.0,3.18,1,3,state_university_of_new_york_at_stony_brook,reject,35
313,165,148,103.0,2.94,60,0,state_university_of_new_york_at_stony_brook,reject,35
317,162,155,98.0,3.78,29,0,state_university_of_new_york_at_stony_brook,reject,35
312,161,151,98.0,2.47,33,3,state_university_of_new_york_at_stony_brook,reject,35
312,161,151,98.0,2.47,33,3,state_university_of_new_york_at_stony_brook,reject,35
317,162,155,100.0,2.98,33,0,state_university_of_new_york_at_stony_brook,reject,35
322,170,152,101.0,3.53,3,0,state_university_of_new_york_at_stony_brook,reject,35
315,168,147,98.0,3.26,17,3,state_university_of_new_york_at_stony_brook,reject,35
312,162,150,91.0,3.27,0,0,state_university_of_new_york_at_stony_brook,reject,35
318,166,152,65.0,3.29,38,2,state_university_of_new_york_at_stony_brook,reject,35
324,169,155,110.0,2.51,13,3,state_university_of_new_york_at_stony_brook,reject,35
320,168,152,101.0,3.44,17,0,state_university_of_new_york_at_stony_brook,reject,35
321,164,157,110.0,1.21,4,3,state_university_of_new_york_at_stony_brook,reject,35
318,165,153,107.0,3.61,29,3,state_university_of_new_york_at_stony_brook,reject,35
320,163,157,108.0,3.26,65,0,state_university_of_new_york_at_stony_brook,reject,35
325,170,155,105.0,3.8,19,0,state_university_of_new_york_at_stony_brook,reject,35
323,162,161,109.0,3.49,19,0,state_university_of_new_york_at_stony_brook,reject,35
320,163,157,110.0,3.54,24,0,state_university_of_new_york_at_stony_brook,reject,35
321,166,155,108.0,3.0,16,3,state_university_of_new_york_at_stony_brook,reject,35
314,170,144,94.0,3.02,0,0,state_university_of_new_york_at_stony_brook,reject,35
319,165,154,101,3.2,51,0,state_university_of_new_york_at_stony_brook,reject,35
319,165,154,101,3.2,51,0,state_university_of_new_york_at_stony_brook,reject,35
318,165,153,108.0,2.3,24,0,state_university_of_new_york_at_stony_brook,reject,35
318,164,154,108.0,2.4,46,0,state_university_of_new_york_at_stony_brook,reject,35
311,165,146,95.0,3.52,0,0,state_university_of_new_york_at_stony_brook,reject,35
302,153,149,91.0,2.56,110,0,state_university_of_new_york_at_stony_brook,reject,35
312,157,155,106.0,3.24,46,0,state_university_of_new_york_at_stony_brook,reject,35
306,159,147,99.0,2.56,29,1,state_university_of_new_york_at_stony_brook,reject,35
313,165,148,101.0,2.71,7,0,state_university_of_new_york_at_stony_brook,reject,35
328,170,158,114.0,2.99,17,0,state_university_of_new_york_at_stony_brook,reject,35
319,169,150,103.0,2.88,27,0,state_university_of_new_york_at_stony_brook,reject,35
310,161,149,95.0,2.32,50,0,state_university_of_new_york_at_stony_brook,reject,35
308,158,150,94.0,3.2,29,0,state_university_of_new_york_at_stony_brook,reject,35
314,157,157,106.0,3.0,60,0,state_university_of_new_york_at_stony_brook,reject,35
324,167,157,105.0,2.88,2,0,state_university_of_new_york_at_stony_brook,reject,35
323,170,153,119.0,3.25,0,0,state_university_of_new_york_at_stony_brook,reject,35
313,163,150,0,2.94,23,3,state_university_of_new_york_at_stony_brook,reject,35
313,163,150,0,2.94,23,3,state_university_of_new_york_at_stony_brook,reject,35
311,161,150,78,3.68,0,0,state_university_of_new_york_at_stony_brook,reject,35
320,163,157,108.0,3.56,3,0,state_university_of_new_york_at_stony_brook,reject,35
324,169,155,112.0,3.1,14,0,state_university_of_new_york_at_stony_brook,reject,35
313,160,153,107.0,2.4,11,0,state_university_of_new_york_at_stony_brook,reject,35
320,162,158,0,2.8,31,0,state_university_of_new_york_at_stony_brook,reject,35
313,156,157,105.0,3.23,17,3,state_university_of_new_york_at_stony_brook,reject,35
328,163,165,0,2.29,12,0,state_university_of_new_york_at_stony_brook,reject,35
321,165,156,0,2.72,14,0,state_university_of_new_york_at_stony_brook,reject,35
321,165,156,0,2.72,14,0,state_university_of_new_york_at_stony_brook,reject,35
302,152,150,0,3.56,2,0,state_university_of_new_york_at_stony_brook,reject,35
317,162,155,115.0,3.1,60,0,state_university_of_new_york_at_stony_brook,reject,35
311,162,149,90.0,2.8,15,2,state_university_of_new_york_at_stony_brook,reject,35
318,165,153,116.0,3.74,32,2,state_university_of_new_york_at_stony_brook,reject,35
324,164,160,116.0,2.95,48,2,state_university_of_new_york_at_stony_brook,reject,35
320,162,158,102.0,3.32,6,3,state_university_of_new_york_at_stony_brook,reject,35
324,167,157,111.0,2.66,40,0,state_university_of_new_york_at_stony_brook,reject,35
294,153,141,88.0,2.8,60,1,state_university_of_new_york_at_stony_brook,reject,35
318,167,151,112.0,2.9,2,3,state_university_of_new_york_at_stony_brook,reject,35
310,161,149,112.0,3.4,25,0,state_university_of_new_york_at_stony_brook,reject,35
320,160,160,0,3.01,0,0,state_university_of_new_york_at_stony_brook,reject,35
325,167,158,113.0,3.44,14,0,state_university_of_new_york_at_stony_brook,reject,35
316,163,153,0,2.68,15,3,state_university_of_new_york_at_stony_brook,reject,35
311,162,149,102.0,2.45,0,3,state_university_of_new_york_at_stony_brook,reject,35
309,162,147,93.0,3.54,18,0,state_university_of_new_york_at_stony_brook,reject,35
330,169,161,113.0,3.6,0,0,state_university_of_new_york_at_stony_brook,reject,35
330,169,161,113.0,3.6,0,0,state_university_of_new_york_at_stony_brook,reject,35
316,166,150,102.0,2.71,36,0,state_university_of_new_york_at_stony_brook,reject,35
325,167,158,103.0,3.18,60,0,state_university_of_new_york_at_stony_brook,reject,35
320,163,157,114.0,2.92,0,0,state_university_of_new_york_at_stony_brook,reject,35
326,168,158,0,3.63,0,0,state_university_of_new_york_at_stony_brook,reject,35
331,165,166,117.0,3.25,23,0,state_university_of_new_york_at_stony_brook,reject,35
319,168,151,0,3.16,14,3,state_university_of_new_york_at_stony_brook,reject,35
314,159,155,106.0,2.95,3,0,state_university_of_new_york_at_stony_brook,reject,35
316,163,153,96.0,2.86,4,0,state_university_of_new_york_at_stony_brook,reject,35
312,160,152,0,2.55,0,0,state_university_of_new_york_at_stony_brook,reject,35
320,162,158,0,3.14,19,3,state_university_of_new_york_at_stony_brook,reject,35
319,170,149,110.0,3.64,49,0,state_university_of_new_york_at_stony_brook,reject,35
319,165,154,106.0,3.59,2,0,state_university_of_new_york_at_stony_brook,reject,35
322,170,152,0,2.98,21,0,state_university_of_new_york_at_stony_brook,reject,35
316,165,151,114.0,2.84,3,3,state_university_of_new_york_at_stony_brook,reject,35
299,155,144,0,3.69,18,0,state_university_of_new_york_at_stony_brook,reject,35
321,167,154,113.0,2.1,24,0,state_university_of_new_york_at_stony_brook,reject,35
321,167,154,113.0,2.1,24,0,state_university_of_new_york_at_stony_brook,reject,35
315,162,153,103.0,3.63,5,0,state_university_of_new_york_at_stony_brook,reject,35
305,158,147,96.0,2.86,15,2,state_university_of_new_york_at_stony_brook,reject,35
315,170,145,101,3.29,0,0,state_university_of_new_york_at_stony_brook,reject,35
319,163,156,107.0,3.62,26,3,state_university_of_new_york_at_stony_brook,reject,35
320,165,155,101.0,2.51,1,0,state_university_of_new_york_at_stony_brook,reject,35
324,167,157,85.0,2.7,6,0,state_university_of_new_york_at_stony_brook,reject,35
312,158,154,104.0,2.96,30,3,state_university_of_new_york_at_stony_brook,reject,35
318,162,156,114.0,3.1,23,0,state_university_of_new_york_at_stony_brook,reject,35
317,170,147,103.0,3.04,21,3,state_university_of_new_york_at_stony_brook,reject,35
317,159,158,99.0,3.3,42,0,state_university_of_new_york_at_stony_brook,reject,35
314,167,147,90.0,2.3,56,0,state_university_of_new_york_at_stony_brook,reject,35
319,163,156,108.0,2.8,48,0,state_university_of_new_york_at_stony_brook,reject,35
314,162,152,106.0,3.28,18,0,state_university_of_new_york_at_stony_brook,reject,35
311,155,156,101.0,3.13,0,0,syracuse_university,accept,118
305,159,146,98.0,2.7,3,2,syracuse_university,accept,118
303,153,150,115.0,3.36,24,3,syracuse_university,accept,118
311,159,152,109.0,2.6,28,2,syracuse_university,accept,118
305,158,147,94.0,3.23,0,3,syracuse_university,accept,118
313,160,153,107.0,2.65,9,0,syracuse_university,accept,118
305,161,144,94.0,3.26,10,0,syracuse_university,accept,118
312,167,145,100.0,2.8,21,0,syracuse_university,accept,118
310,160,150,103.0,2.4,17,0,syracuse_university,accept,118
316,164,152,101.0,3.46,0,0,syracuse_university,accept,118
313,161,152,104.0,2.4,12,3,syracuse_university,accept,118
318,164,154,107.0,2.33,13,2,syracuse_university,accept,118
327,167,160,110.0,2.8,9,3,syracuse_university,accept,118
310,160,150,98.0,3.08,0,3,syracuse_university,accept,118
317,163,154,109.0,2.45,28,0,syracuse_university,accept,118
313,161,152,113.0,2.84,18,0,syracuse_university,accept,118
313,161,152,113.0,2.84,18,0,syracuse_university,accept,118
318,163,155,114.0,2.94,24,0,syracuse_university,accept,118
313,168,145,101.0,3.14,0,0,syracuse_university,accept,118
308,158,150,96.0,3.16,5,3,syracuse_university,accept,118
320,168,152,98.0,3.0,0,0,syracuse_university,accept,118
312,168,144,101,3.0,20,0,syracuse_university,accept,118
305,159,146,65.0,2.6,47,3,syracuse_university,accept,118
311,164,147,99.0,3.46,17,0,syracuse_university,accept,118
320,160,160,109.0,3.27,1,3,syracuse_university,accept,118
308,159,149,98.0,2.2,29,0,syracuse_university,accept,118
306,165,141,85.0,3.62,20,0,syracuse_university,accept,118
312,165,147,91.0,2.6,60,0,syracuse_university,accept,118
308,166,142,91.0,3.44,8,0,syracuse_university,accept,118
301,162,139,86.0,3.24,0,0,syracuse_university,accept,118
322,164,158,75.0,2.65,30,0,syracuse_university,accept,118
321,170,151,103.0,3.6,6,3,syracuse_university,accept,118
315,161,154,100.0,2.32,1,3,syracuse_university,accept,118
313,169,144,100.0,3.07,20,0,syracuse_university,accept,118
316,152,164,104.0,3.08,6,0,syracuse_university,accept,118
316,152,164,104.0,3.08,6,0,syracuse_university,accept,118
309,163,146,101.0,2.75,9,0,syracuse_university,accept,118
298,162,136,92.0,2.65,4,0,syracuse_university,accept,118
299,155,144,75.0,2.88,22,0,syracuse_university,accept,118
305,160,145,92.0,3.12,24,1,syracuse_university,accept,118
311,159,152,104.0,3.1,21,3,syracuse_university,accept,118
318,168,150,101,2.92,12,0,syracuse_university,accept,118
325,170,155,108.0,3.4,18,0,syracuse_university,accept,118
308,163,145,75.0,3.1,12,0,syracuse_university,accept,118
302,159,143,88.0,2.5,24,0,syracuse_university,accept,118
303,159,144,114,3.48,23,0,syracuse_university,accept,118
310,163,147,100.0,3.15,5,0,syracuse_university,accept,118
315,165,150,96.0,3.25,1,0,syracuse_university,accept,118
304,162,142,107.0,3.5,50,0,syracuse_university,accept,118
303,157,146,105.0,2.62,24,3,syracuse_university,accept,118
305,158,147,101,3.38,4,0,syracuse_university,accept,118
311,165,146,95.0,3.52,0,0,syracuse_university,accept,118
309,161,148,92.0,3.6,10,3,syracuse_university,accept,118
309,161,148,92.0,3.6,10,3,syracuse_university,accept,118
316,161,155,114.0,3.12,15,0,syracuse_university,accept,118
313,157,156,108.0,1.75,18,0,syracuse_university,accept,118
306,161,145,75.0,3.22,0,0,syracuse_university,accept,118
329,167,162,118.0,2.23,10,0,syracuse_university,accept,118
318,165,153,111.0,3.24,48,0,syracuse_university,accept,118
317,161,156,75.0,3.47,1,0,syracuse_university,accept,118
309,160,149,97.0,3.24,0,1,syracuse_university,accept,118
308,165,143,102.0,2.5,52,1,syracuse_university,accept,118
314,164,150,104.0,3.43,2,0,syracuse_university,accept,118
316,165,151,100.0,2.09,60,0,syracuse_university,accept,118
310,161,149,108.0,3.02,3,0,syracuse_university,accept,118
297,152,145,94.0,3.52,12,0,syracuse_university,accept,118
314,169,145,102.0,2.33,24,0,syracuse_university,accept,118
304,157,147,94.0,3.28,0,0,syracuse_university,accept,118
317,165,152,101.0,2.35,18,3,syracuse_university,accept,118
303,160,143,93.0,3.03,19,0,syracuse_university,accept,118
320,164,156,112.0,2.33,15,3,syracuse_university,accept,118
320,164,156,112.0,2.33,15,3,syracuse_university,accept,118
310,159,151,103.0,3.18,39,0,syracuse_university,accept,118
319,166,153,91.0,3.14,0,3,syracuse_university,accept,118
306,157,149,107.0,2.61,11,0,syracuse_university,accept,118
321,170,151,75.0,3.32,0,0,syracuse_university,accept,118
322,169,153,110.0,3.16,52,0,syracuse_university,accept,118
306,157,149,106.0,3.52,0,3,syracuse_university,accept,118
310,161,149,90.0,2.65,48,0,syracuse_university,accept,118
313,165,148,97.0,2.98,0,0,syracuse_university,accept,118
319,165,154,102.0,2.94,8,0,syracuse_university,accept,118
319,160,159,109.0,2.6,40,0,syracuse_university,accept,118
308,163,145,90.0,3.48,0,0,syracuse_university,accept,118
308,164,144,100.0,3.28,1,3,syracuse_university,accept,118
314,161,153,95.0,3.16,44,0,syracuse_university,accept,118
314,168,146,0,3.23,0,0,syracuse_university,accept,118
302,158,144,89.0,2.65,0,0,syracuse_university,accept,118
314,168,146,65.0,2.65,29,0,syracuse_university,accept,118
314,168,146,65.0,2.65,29,0,syracuse_university,accept,118
317,169,148,95.0,3.24,0,0,syracuse_university,accept,118
329,167,162,106.0,2.15,36,0,syracuse_university,accept,118
307,160,147,111.0,2.8,0,0,syracuse_university,accept,118
309,158,151,94.0,3.22,19,0,syracuse_university,accept,118
316,162,154,114,3.38,0,0,syracuse_university,accept,118
311,163,148,104.0,2.49,40,1,syracuse_university,accept,118
321,164,157,106.0,1.28,23,0,syracuse_university,accept,118
313,158,155,109.0,3.18,0,3,syracuse_university,accept,118
317,168,149,102.0,2.98,3,0,syracuse_university,accept,118
313,170,143,65.0,2.63,9,0,syracuse_university,accept,118
306,160,146,0,3.1,17,0,syracuse_university,accept,118
304,156,148,102.0,3.05,42,0,syracuse_university,accept,118
307,161,146,99.0,2.99,6,0,syracuse_university,accept,118
311,156,155,0,3.14,35,0,syracuse_university,accept,118
318,163,155,110.0,3.33,51,0,syracuse_university,accept,118
306,159,147,96.0,2.61,44,0,syracuse_university,accept,118
308,160,148,107.0,2.39,36,0,syracuse_university,accept,118
326,165,161,118.0,2.35,0,0,syracuse_university,accept,118
304,162,142,97.0,2.9,0,0,syracuse_university,accept,118
315,165,150,103.0,3.75,4,1,syracuse_university,accept,118
315,165,150,103.0,3.75,4,1,syracuse_university,accept,118
315,162,153,110.0,2.92,1,0,syracuse_university,accept,118
313,162,151,106.0,3.15,23,0,syracuse_university,accept,118
298,150,148,106.0,2.11,15,3,syracuse_university,accept,118
302,152,150,0,3.56,2,0,syracuse_university,accept,118
319,164,155,0,2.45,42,0,syracuse_university,accept,118
321,166,155,105.0,3.14,0,0,syracuse_university,accept,118
310,158,152,96.0,2.54,1,3,syracuse_university,accept,118
303,161,142,89.0,2.25,30,0,syracuse_university,accept,118
307,164,143,0,3.33,0,2,syracuse_university,accept,118
313,169,144,101.0,3.12,0,0,syracuse_university,accept,118
315,164,151,105.0,2.92,40,0,syracuse_university,accept,118
307,159,148,75.0,3.44,0,3,syracuse_university,accept,118
303,157,146,94.0,2.9,33,0,syracuse_university,accept,118
312,162,150,109.0,2.15,27,3,syracuse_university,accept,118
315,161,154,111.0,2.75,22,0,syracuse_university,accept,118
309,162,147,93.0,2.25,1,0,syracuse_university,accept,118
316,163,153,104.0,3.68,18,0,syracuse_university,accept,118
316,163,153,104.0,3.68,18,0,syracuse_university,accept,118
308,160,148,103.0,3.42,24,0,syracuse_university,accept,118
319,168,151,115.0,3.67,24,2,syracuse_university,accept,118
311,162,149,0,2.76,29,0,syracuse_university,accept,118
313,160,153,100.0,3.12,0,0,syracuse_university,accept,118
302,157,145,101,3.3,27,0,syracuse_university,accept,118
311,160,151,107.0,3.26,1,0,syracuse_university,accept,118
300,156,144,93.0,3.62,24,0,syracuse_university,accept,118
314,162,152,89.0,3.12,0,0,syracuse_university,accept,118
322,165,157,101,3.1,6,0,syracuse_university,accept,118
319,164,155,109.0,3.18,0,0,syracuse_university,accept,118
310,164,146,106.0,2.07,13,3,syracuse_university,accept,118
304,162,142,95.0,2.4,3,3,syracuse_university,accept,118
304,162,142,95.0,2.4,3,3,syracuse_university,accept,118
312,160,152,98.0,3.24,0,0,syracuse_university,accept,118
309,159,150,93.0,2.4,40,0,syracuse_university,accept,118
308,163,145,83.0,3.36,2,0,syracuse_university,accept,118
300,150,150,98.0,3.5,0,2,syracuse_university,accept,118
314,162,152,111.0,3.11,1,0,syracuse_university,accept,118
313,164,149,75.0,3.5,13,1,syracuse_university,accept,118
313,164,149,75.0,3.5,13,1,syracuse_university,accept,118
307,157,150,101.0,3.1,0,0,syracuse_university,accept,118
305,160,145,95.0,2.0,0,3,syracuse_university,accept,118
314,159,155,110.0,3.15,0,0,syracuse_university,accept,118
312,162,150,90.0,2.25,15,0,syracuse_university,accept,118
304,160,144,100.0,3.12,1,0,syracuse_university,accept,118
306,162,144,97.0,3.2,21,2,syracuse_university,accept,118
308,160,148,106.0,2.5,0,0,syracuse_university,accept,118
308,158,150,105.0,3.21,0,0,syracuse_university,accept,118
312,162,150,88.0,2.21,30,0,syracuse_university,accept,118
304,163,141,98.0,3.31,0,0,syracuse_university,accept,118
301,150,151,96.0,2.18,12,0,syracuse_university,accept,118
301,158,143,88.0,2.1,26,3,syracuse_university,accept,118
319,168,151,107.0,2.0,0,0,syracuse_university,accept,118
307,163,144,101,2.75,0,0,syracuse_university,accept,118
307,161,146,101.0,2.1,33,0,syracuse_university,accept,118
312,160,152,114.0,3.51,0,0,syracuse_university,accept,118
307,159,148,95.0,3.2,0,0,syracuse_university,accept,118
301,149,152,103.0,3.16,0,0,syracuse_university,accept,118
316,164,152,97.0,2.6,2,0,syracuse_university,accept,118
316,164,152,97.0,2.6,2,0,syracuse_university,accept,118
312,161,151,0,3.14,2,0,syracuse_university,accept,118
315,166,149,0,3.08,4,0,syracuse_university,accept,118
310,162,148,95.0,3.2,0,3,syracuse_university,accept,118
314,163,151,104.0,2.5,0,0,syracuse_university,accept,118
312,165,147,85.0,3.11,0,0,syracuse_university,accept,118
328,168,160,108.0,2.1,24,0,syracuse_university,accept,118
317,170,147,90.0,3.15,10,0,syracuse_university,accept,118
305,159,146,95.0,2.6,41,0,syracuse_university,accept,118
300,155,145,101,3.24,0,0,syracuse_university,accept,118
314,162,152,109.0,2.96,13,0,syracuse_university,accept,118
305,161,144,96.0,1.3,3,0,syracuse_university,accept,118
315,165,150,103.0,2.55,42,0,syracuse_university,accept,118
306,163,143,90.0,2.3,24,0,syracuse_university,accept,118
323,165,158,108.0,3.1,20,0,syracuse_university,accept,118
312,161,151,103.0,2.08,26,3,syracuse_university,accept,118
316,167,149,96.0,2.51,24,0,syracuse_university,accept,118
306,158,148,98.0,3.01,20,0,syracuse_university,accept,118
306,164,142,92.0,2.2,44,0,syracuse_university,accept,118
321,164,157,109.0,3.29,33,0,syracuse_university,accept,118
321,164,157,109.0,3.29,33,0,syracuse_university,accept,118
303,154,149,101.0,2.75,6,0,syracuse_university,accept,118
316,164,152,106.0,2.04,12,0,syracuse_university,accept,118
311,168,143,91.0,3.56,8,3,syracuse_university,accept,118
309,160,149,101.0,2.93,0,0,syracuse_university,accept,118
316,152,164,102.0,2.75,0,0,syracuse_university,accept,118
308,160,148,100.0,2.31,0,0,syracuse_university,accept,118
316,166,150,102.0,3.0,3,3,syracuse_university,accept,118
321,162,159,116.0,3.54,1,3,syracuse_university,accept,118
310,163,147,86.0,2.25,31,0,syracuse_university,accept,118
310,157,153,103.0,2.9,0,0,syracuse_university,accept,118
315,162,153,87.0,3.08,0,0,syracuse_university,accept,118
319,161,158,112.0,2.6,6,3,syracuse_university,accept,118
315,162,153,87.0,3.08,0,0,syracuse_university,accept,118
303,158,145,65.0,2.84,14,0,syracuse_university,accept,118
310,158,152,101.0,3.33,77,0,syracuse_university,accept,118
305,159,146,90.0,3.67,21,0,syracuse_university,accept,118
318,167,151,104.0,2.25,4,0,syracuse_university,accept,118
312,161,151,97.0,3.4,14,0,syracuse_university,accept,118
311,163,148,100.0,2.75,0,0,syracuse_university,accept,118
311,162,149,100.0,3.08,0,0,syracuse_university,accept,118
319,164,155,115.0,2.95,24,0,syracuse_university,accept,118
310,158,152,98.0,3.68,15,0,syracuse_university,accept,118
308,157,151,96.0,2.5,34,0,syracuse_university,accept,118
301,157,144,93.0,2.6,5,0,syracuse_university,accept,118
312,162,150,106.0,2.57,0,0,syracuse_university,accept,118
308,164,144,96.0,3.2,0,3,syracuse_university,accept,118
310,168,142,101.0,2.76,42,3,syracuse_university,accept,118
313,164,149,102.0,3.4,0,0,syracuse_university,accept,118
306,154,152,102.0,2.91,31,2,syracuse_university,accept,118
307,160,147,105.0,2.77,5,0,syracuse_university,accept,118
317,163,154,94.0,2.1,0,0,syracuse_university,accept,118
320,169,151,102.0,2.47,12,0,syracuse_university,accept,118
320,169,151,102.0,2.47,12,0,syracuse_university,accept,118
308,160,148,91.0,2.33,10,2,syracuse_university,accept,118
300,153,147,92.0,3.79,0,0,syracuse_university,accept,118
314,162,152,104.0,2.35,38,2,syracuse_university,accept,118
318,165,153,109.0,2.05,55,0,syracuse_university,accept,118
305,163,142,90.0,3.46,24,0,syracuse_university,accept,118
307,162,145,92.0,3.74,30,0,syracuse_university,accept,118
316,165,151,99.0,3.03,16,0,syracuse_university,accept,118
308,159,149,104.0,2.64,14,2,syracuse_university,accept,118
309,164,145,103.0,2.75,2,0,syracuse_university,accept,118
309,158,151,103.0,3.08,44,1,syracuse_university,accept,118
300,152,148,98.0,2.65,5,0,syracuse_university,accept,118
327,165,162,110.0,3.4,12,3,syracuse_university,accept,118
306,155,151,108.0,3.11,0,3,syracuse_university,accept,118
305,155,150,94.0,3.21,30,0,syracuse_university,accept,118
313,165,148,92.0,3.29,10,0,syracuse_university,accept,118
316,159,157,99.0,3.3,41,0,syracuse_university,accept,118
309,167,142,91.0,2.96,60,0,syracuse_university,accept,118
316,161,155,109.0,2.68,32,2,syracuse_university,reject,118
316,161,155,109.0,2.68,32,2,syracuse_university,reject,118
304,154,150,75.0,2.25,16,0,syracuse_university,reject,118
306,160,146,90.0,2.84,0,0,syracuse_university,reject,118
312,160,152,90.0,2.7,0,3,syracuse_university,reject,118
304,157,147,95.0,2.82,0,0,syracuse_university,reject,118
322,163,159,106.0,2.71,2,2,syracuse_university,reject,118
318,157,161,111.0,2.68,36,0,syracuse_university,reject,118
304,160,144,83.0,1.95,26,3,syracuse_university,reject,118
303,156,147,93.0,2.5,4,0,syracuse_university,reject,118
302,157,145,95.0,2.05,30,0,syracuse_university,reject,118
303,162,141,96.0,2.96,20,3,syracuse_university,reject,118
308,161,147,87.0,2.47,20,0,syracuse_university,reject,118
317,161,156,114,2.8,10,0,syracuse_university,reject,118
309,162,147,94.0,3.23,14,0,syracuse_university,reject,118
317,165,152,96.0,2.98,4,0,syracuse_university,reject,118
310,159,151,93.0,2.78,14,0,syracuse_university,reject,118
307,163,144,92.0,2.76,11,1,syracuse_university,reject,118
305,167,138,65.0,3.02,10,0,syracuse_university,reject,118
314,152,162,99.0,2.55,38,0,syracuse_university,reject,118
308,161,147,102.0,2.72,0,0,syracuse_university,reject,118
304,155,149,107.0,2.92,22,0,syracuse_university,reject,118
304,155,149,107.0,2.92,22,0,syracuse_university,reject,118
307,158,149,114,2.63,34,0,syracuse_university,reject,118
304,155,149,75.0,2.7,0,0,syracuse_university,reject,118
301,153,148,96.0,2.91,9,0,syracuse_university,reject,118
315,160,155,75.0,3.01,13,0,syracuse_university,reject,118
319,168,151,106.0,2.05,38,0,syracuse_university,reject,118
308,156,152,102.0,3.06,7,3,syracuse_university,reject,118
301,162,139,101,2.33,0,0,syracuse_university,reject,118
329,168,161,110.0,3.39,3,2,syracuse_university,reject,118
301,159,142,101,1.95,0,3,syracuse_university,reject,118
307,165,142,82.0,1.75,30,0,syracuse_university,reject,118
308,166,142,95.0,2.17,35,3,syracuse_university,reject,118
306,159,147,99.0,2.56,29,1,syracuse_university,reject,118
309,158,151,0,2.48,60,0,syracuse_university,reject,118
303,155,148,105.0,1.95,6,0,syracuse_university,reject,118
300,156,144,88.0,3.16,14,0,syracuse_university,reject,118
295,156,139,65.0,3.19,0,0,syracuse_university,reject,118
306,157,149,94.0,2.53,0,2,syracuse_university,reject,118
299,158,141,75.0,3.42,12,0,syracuse_university,reject,118
295,158,137,0,2.1,28,2,syracuse_university,reject,118
316,162,154,106.0,2.0,0,0,syracuse_university,reject,118
316,162,154,106.0,2.0,0,0,syracuse_university,reject,118
312,163,149,100.0,2.1,30,1,syracuse_university,reject,118
304,156,148,103.0,2.2,0,2,syracuse_university,reject,118
304,152,152,106.0,3.26,28,0,syracuse_university,reject,118
310,166,144,114,2.42,0,0,syracuse_university,reject,118
293,150,143,83.0,2.84,0,0,syracuse_university,reject,118
302,156,146,99.0,2.88,0,3,syracuse_university,reject,118
311,160,151,106.0,3.16,3,0,syracuse_university,reject,118
307,164,143,104.0,2.7,3,0,syracuse_university,reject,118
313,167,146,93.0,3.52,30,0,syracuse_university,reject,118
300,154,146,96.0,2.53,2,0,syracuse_university,reject,118
301,153,148,95.0,1.82,12,3,syracuse_university,reject,118
315,164,151,105.0,3.32,27,0,syracuse_university,reject,118
305,158,147,96.0,3.08,0,0,syracuse_university,reject,118
308,160,148,98.0,2.42,6,3,syracuse_university,reject,118
305,161,144,105.0,3.29,24,3,syracuse_university,reject,118
292,152,140,98.0,2.8,24,3,syracuse_university,reject,118
307,163,144,95.0,2.94,30,0,syracuse_university,reject,118
296,153,143,100.0,2.25,2,0,syracuse_university,reject,118
303,155,148,106.0,3.22,8,0,syracuse_university,reject,118
314,157,157,110.0,2.28,20,0,syracuse_university,reject,118
314,157,157,110.0,2.28,20,0,syracuse_university,reject,118
305,158,147,108.0,3.16,18,2,syracuse_university,reject,118
303,163,140,81.0,2.77,8,0,syracuse_university,reject,118
300,155,145,93.0,3.12,13,0,syracuse_university,reject,118
309,165,144,93.0,2.35,5,0,syracuse_university,reject,118
311,162,149,105.0,2.45,0,0,syracuse_university,reject,118
315,161,154,0,2.84,1,0,syracuse_university,reject,118
314,161,153,100.0,2.2,0,0,syracuse_university,reject,118
316,164,152,91.0,2.6,0,0,syracuse_university,reject,118
308,159,149,96.0,2.88,32,0,syracuse_university,reject,118
301,160,141,87.0,3.42,0,0,syracuse_university,reject,118
305,158,147,0,2.8,3,0,syracuse_university,reject,118
297,154,143,90.0,2.96,0,3,syracuse_university,reject,118
310,163,147,101,2.91,0,0,syracuse_university,reject,118
304,160,144,91.0,3.2,57,0,syracuse_university,reject,118
305,158,147,93.0,2.28,5,0,syracuse_university,reject,118
301,159,142,87.0,2.83,15,0,syracuse_university,reject,118
314,165,149,91.0,2.47,0,0,syracuse_university,reject,118
314,163,151,91.0,3.22,28,0,syracuse_university,reject,118
307,158,149,105.0,2.72,10,3,syracuse_university,reject,118
313,162,151,103.0,2.55,38,0,syracuse_university,reject,118
313,162,151,103.0,2.55,38,0,syracuse_university,reject,118
302,160,142,92.0,2.81,16,0,syracuse_university,reject,118
321,167,154,105.0,1.8,29,3,syracuse_university,reject,118
306,160,146,86.0,3.05,10,0,syracuse_university,reject,118
304,156,148,104.0,2.7,25,0,syracuse_university,reject,118
294,146,148,0,2.56,18,0,syracuse_university,reject,118
306,160,146,99.0,2.73,0,0,syracuse_university,reject,118
314,163,151,97.0,3.09,0,0,syracuse_university,reject,118
305,161,144,97.0,2.92,14,0,syracuse_university,reject,118
310,157,153,99.0,2.55,21,0,syracuse_university,reject,118
309,161,148,0,2.19,2,0,syracuse_university,reject,118
317,165,152,105.0,2.16,1,3,syracuse_university,reject,118
305,164,141,101,3.15,12,0,syracuse_university,reject,118
308,158,150,100.0,2.97,25,0,syracuse_university,reject,118
316,161,155,105.0,2.6,30,2,syracuse_university,reject,118
303,157,146,86.0,2.85,0,0,syracuse_university,reject,118
312,161,151,100.0,2.35,36,0,syracuse_university,reject,118
304,165,139,86.0,2.98,36,3,syracuse_university,reject,118
302,163,139,87.0,3.1,44,0,syracuse_university,reject,118
310,160,150,103.0,2.04,55,0,syracuse_university,reject,118
310,160,150,103.0,2.04,55,0,syracuse_university,reject,118
313,157,156,89.0,2.12,0,0,syracuse_university,reject,118
311,166,145,98.0,2.15,0,0,syracuse_university,reject,118
303,162,141,81.0,2.25,9,1,syracuse_university,reject,118
313,162,151,102.0,2.9,33,0,syracuse_university,reject,118
306,158,148,106.0,2.98,24,2,syracuse_university,reject,118
297,154,143,95.0,2.35,18,0,syracuse_university,reject,118
322,168,154,114.0,2.1,40,0,syracuse_university,reject,118
301,156,145,86.0,2.2,30,0,syracuse_university,reject,118
303,157,146,100.0,2.52,0,0,syracuse_university,reject,118
303,159,144,95.0,2.72,9,0,syracuse_university,reject,118
320,159,161,111.0,2.77,52,0,syracuse_university,reject,118
314,167,147,95.0,2.86,12,0,syracuse_university,reject,118
309,163,146,90.0,3.26,6,0,syracuse_university,reject,118
300,160,140,65.0,2.1,17,0,syracuse_university,reject,118
309,166,143,100.0,2.3,0,1,syracuse_university,reject,118
302,153,149,89.0,3.32,24,0,syracuse_university,reject,118
315,164,151,109.0,2.62,7,0,syracuse_university,reject,118
317,160,157,108.0,2.96,18,0,syracuse_university,reject,118
318,168,150,101,2.36,21,0,syracuse_university,reject,118
318,168,150,101,2.36,21,0,syracuse_university,reject,118
308,161,147,90.0,3.2,24,0,syracuse_university,reject,118
307,158,149,97.0,3.34,0,0,syracuse_university,reject,118
330,167,163,115.0,2.1,19,0,syracuse_university,reject,118
299,157,142,78,3.39,33,0,syracuse_university,reject,118
312,157,155,101.0,2.82,0,0,syracuse_university,reject,118
311,163,148,105.0,2.81,0,3,syracuse_university,reject,118
309,163,146,88.0,2.45,2,3,syracuse_university,reject,118
309,161,148,106.0,2.1,53,0,syracuse_university,reject,118
300,157,143,92.0,2.58,1,0,syracuse_university,reject,118
324,170,154,98.0,2.36,0,0,syracuse_university,reject,118
313,166,147,0,1.99,29,0,syracuse_university,reject,118
312,162,150,97.0,2.76,0,0,syracuse_university,reject,118
324,166,158,110.0,2.0,16,0,syracuse_university,reject,118
308,156,152,112.0,2.88,0,0,syracuse_university,reject,118
309,157,152,98.0,3.21,3,3,syracuse_university,reject,118
303,159,144,83.0,3.08,3,0,syracuse_university,reject,118
313,165,148,89.0,2.84,19,3,syracuse_university,reject,118
303,160,143,91.0,3.06,8,0,syracuse_university,reject,118
312,163,149,105.0,2.96,2,0,syracuse_university,reject,118
315,164,151,103.0,2.0,30,3,syracuse_university,reject,118
315,164,151,103.0,2.0,30,3,syracuse_university,reject,118
317,160,157,109.0,2.63,0,0,syracuse_university,reject,118
317,162,155,104.0,2.17,77,0,syracuse_university,reject,118
315,160,155,114.0,2.28,12,0,syracuse_university,reject,118
299,156,143,100.0,2.4,29,0,syracuse_university,reject,118
300,144,156,92.0,2.98,2,3,syracuse_university,reject,118
317,165,152,109.0,2.67,33,0,syracuse_university,reject,118
309,165,144,87.0,2.92,30,2,syracuse_university,reject,118
300,150,150,100.0,1.9,0,3,syracuse_university,reject,118
311,164,147,99.0,3.16,30,0,syracuse_university,reject,118
315,167,148,101.0,2.09,30,0,syracuse_university,reject,118
314,162,152,110.0,2.0,15,0,syracuse_university,reject,118
311,158,153,102.0,2.15,14,3,syracuse_university,reject,118
317,162,155,102.0,1.85,14,2,syracuse_university,reject,118
309,159,150,104.0,3.07,30,0,syracuse_university,reject,118
318,168,150,106.0,1.88,18,3,syracuse_university,reject,118
307,158,149,98.0,1.95,44,2,syracuse_university,reject,118
306,155,151,104.0,2.95,6,3,syracuse_university,reject,118
309,157,152,108.0,2.97,0,3,syracuse_university,reject,118
306,155,151,104.0,2.95,6,3,syracuse_university,reject,118
309,157,152,108.0,2.97,0,3,syracuse_university,reject,118
320,167,153,102.0,2.44,37,0,syracuse_university,reject,118
312,160,152,95.0,1.9,30,0,syracuse_university,reject,118
312,160,152,95.0,1.9,30,0,syracuse_university,reject,118
312,159,153,100.0,2.5,40,0,syracuse_university,reject,118
306,158,148,99.0,2.35,15,1,syracuse_university,reject,118
307,158,149,94.0,3.24,0,0,syracuse_university,reject,118
318,167,151,102.0,2.27,40,0,syracuse_university,reject,118
302,161,141,96.0,3.52,30,3,syracuse_university,reject,118
311,167,144,113.0,3.11,0,0,syracuse_university,reject,118
299,157,142,99.0,2.72,15,3,syracuse_university,reject,118
308,157,151,104.0,3.2,20,0,syracuse_university,reject,118
328,167,161,75.0,3.0,12,0,syracuse_university,reject,118
305,161,144,89.0,3.09,12,0,syracuse_university,reject,118
316,163,153,103.0,2.14,9,3,syracuse_university,reject,118
311,162,149,105.0,2.43,38,0,syracuse_university,reject,118
310,163,147,100.0,2.95,17,2,syracuse_university,reject,118
312,162,150,99.0,2.72,6,0,syracuse_university,reject,118
309,163,146,99.0,3.36,10,3,syracuse_university,reject,118
312,160,152,97.0,2.85,0,0,syracuse_university,reject,118
307,157,150,97.0,3.0,0,0,syracuse_university,reject,118
319,161,158,110.0,2.15,0,0,syracuse_university,reject,118
310,161,149,102.0,1.73,32,2,syracuse_university,reject,118
310,161,149,102.0,1.73,32,2,syracuse_university,reject,118
300,156,144,103.0,2.98,30,0,syracuse_university,reject,118
305,155,150,108.0,2.32,15,3,syracuse_university,reject,118
305,161,144,97.0,3.23,0,0,syracuse_university,reject,118
298,156,142,90.0,2.15,24,0,syracuse_university,reject,118
308,160,148,92.0,3.36,30,0,syracuse_university,reject,118
300,156,144,102.0,2.88,0,3,syracuse_university,reject,118
301,158,143,88.0,2.44,0,0,syracuse_university,reject,118
309,162,147,97.0,2.2,12,2,syracuse_university,reject,118
300,158,142,88.0,2.95,24,0,syracuse_university,reject,118
301,157,144,91.0,2.27,10,0,syracuse_university,reject,118
308,159,149,98.0,2.01,30,0,syracuse_university,reject,118
310,162,148,99.0,2.1,0,0,syracuse_university,reject,118
304,154,150,95.0,2.44,0,3,syracuse_university,reject,118
311,161,150,103.0,3.03,10,3,syracuse_university,reject,118
316,162,154,104.0,2.78,2,0,syracuse_university,reject,118
317,167,150,75.0,2.4,9,0,syracuse_university,reject,118
305,159,146,105.0,2.17,20,0,syracuse_university,reject,118
316,163,153,96.0,1.87,11,3,syracuse_university,reject,118
308,163,145,92.0,2.92,22,0,syracuse_university,reject,118
304,160,144,96.0,3.04,24,0,syracuse_university,reject,118
304,160,144,96.0,3.04,24,0,syracuse_university,reject,118
301,156,145,91.0,1.92,16,0,syracuse_university,reject,118
303,155,148,106.0,2.1,40,0,syracuse_university,reject,118
306,162,144,90.0,3.1,0,0,syracuse_university,reject,118
312,163,149,103.0,2.94,0,0,syracuse_university,reject,118
301,162,139,98.0,2.75,24,3,syracuse_university,reject,118
325,166,159,104.0,2.76,2,0,syracuse_university,reject,118
320,163,157,107.0,2.54,36,0,syracuse_university,reject,118
307,164,143,84.0,3.24,30,0,syracuse_university,reject,118
312,160,152,111.0,2.25,12,0,syracuse_university,reject,118
315,161,154,101.0,1.6,0,0,syracuse_university,reject,118
303,161,142,78,3.58,1,0,syracuse_university,reject,118
319,162,157,109.0,1.86,0,3,syracuse_university,reject,118
321,169,152,108.0,1.96,0,0,syracuse_university,reject,118
317,167,150,100.0,2.54,24,0,syracuse_university,reject,118
319,161,158,118.0,2.33,0,0,syracuse_university,reject,118
307,159,148,86.0,2.47,0,0,syracuse_university,reject,118
299,153,146,97.0,2.96,24,3,syracuse_university,reject,118
311,156,155,108.0,2.15,26,2,syracuse_university,reject,118
305,156,149,86.0,2.4,0,3,syracuse_university,reject,118
305,156,149,86.0,2.4,0,3,syracuse_university,reject,118
322,170,152,101.0,2.4,30,0,syracuse_university,reject,118
296,158,138,98.0,2.1,30,0,syracuse_university,reject,118
308,159,149,93.0,2.46,30,3,syracuse_university,reject,118
308,158,150,100.0,2.1,0,0,syracuse_university,reject,118
306,158,148,104.0,2.5,30,0,syracuse_university,reject,118
326,170,156,108.0,1.8,0,0,syracuse_university,reject,118
309,159,150,105.0,2.35,0,0,syracuse_university,reject,118
307,162,145,108.0,2.05,0,0,syracuse_university,reject,118
304,157,147,102.0,3.82,0,0,syracuse_university,reject,118
308,163,145,100.0,3.33,0,0,syracuse_university,reject,118
314,158,156,109.0,3.11,0,3,syracuse_university,reject,118
307,156,151,94.0,2.05,10,0,syracuse_university,reject,118
315,163,152,100.0,2.92,20,0,syracuse_university,reject,118
305,158,147,104.0,3.42,10,0,syracuse_university,reject,118
316,154,162,113.0,3.22,30,0,syracuse_university,reject,118
316,165,151,96.0,1.97,30,0,syracuse_university,reject,118
308,159,149,108.0,2.97,20,0,syracuse_university,reject,118
306,163,143,98.0,2.25,30,0,syracuse_university,reject,118
322,164,158,108.0,3.08,10,3,syracuse_university,reject,118
304,161,143,86.0,1.9,0,0,syracuse_university,reject,118
304,161,143,86.0,1.9,0,0,syracuse_university,reject,118
310,163,147,95.0,2.5,0,0,syracuse_university,reject,118
318,160,158,95.0,2.33,0,3,syracuse_university,reject,118
298,154,144,96.0,3.75,0,3,syracuse_university,reject,118
315,163,152,97.0,2.05,0,0,syracuse_university,reject,118
302,155,147,109.0,1.9,10,0,syracuse_university,reject,118
309,159,150,90.0,3.4,30,0,syracuse_university,reject,118
303,159,144,80.0,2.5,30,0,syracuse_university,reject,118
320,164,156,116.0,1.81,20,0,syracuse_university,reject,118
303,159,144,87.0,3.24,0,0,syracuse_university,reject,118
289,144,145,85.0,3.32,0,0,syracuse_university,reject,118
290,152,138,79.0,2.3,0,2,syracuse_university,reject,118
306,157,149,103.0,1.9,20,3,syracuse_university,reject,118
312,161,151,114,2.15,30,0,syracuse_university,reject,118
313,159,154,102.0,2.45,30,3,syracuse_university,reject,118
305,160,145,101,3.1,30,0,syracuse_university,reject,118
309,159,150,98.0,3.31,0,0,syracuse_university,reject,118
301,158,143,78,1.9,0,0,syracuse_university,reject,118
313,166,147,108.0,2.3,0,0,syracuse_university,reject,118
316,160,156,98.0,2.4,0,0,syracuse_university,reject,118
316,160,156,98.0,2.4,0,0,syracuse_university,reject,118
310,164,146,98.0,2.86,0,0,syracuse_university,reject,118
310,168,142,79.0,2.75,0,0,syracuse_university,reject,118
310,161,149,94.0,2.4,0,0,syracuse_university,reject,118
300,151,149,108.0,3.08,0,0,syracuse_university,reject,118
322,161,161,99.0,2.4,0,0,syracuse_university,reject,118
318,162,156,110.0,2.3,0,3,syracuse_university,reject,118
313,163,150,101.0,2.68,10,2,syracuse_university,reject,118
300,158,142,94.0,2.99,30,0,syracuse_university,reject,118
313,169,144,75.0,3.91,0,0,texas_a_m_university_college_station,accept,31
322,167,155,111.0,3.35,42,0,texas_a_m_university_college_station,accept,31
316,168,148,110.0,3.92,15,0,texas_a_m_university_college_station,accept,31
318,168,150,108.0,3.45,0,0,texas_a_m_university_college_station,accept,31
324,169,155,107.0,3.27,20,0,texas_a_m_university_college_station,accept,31
326,166,160,112.0,3.84,13,3,texas_a_m_university_college_station,accept,31
323,166,157,110.0,3.42,3,3,texas_a_m_university_college_station,accept,31
327,170,157,0,3.45,40,3,texas_a_m_university_college_station,accept,31
331,170,161,117.0,3.9,18,0,texas_a_m_university_college_station,accept,31
322,170,152,105.0,3.17,25,2,texas_a_m_university_college_station,accept,31
324,170,154,112.0,3.31,57,0,texas_a_m_university_college_station,accept,31
324,167,157,115.0,3.86,0,0,texas_a_m_university_college_station,accept,31
322,166,156,110.0,3.34,20,0,texas_a_m_university_college_station,accept,31
334,170,164,111.0,3.63,7,3,texas_a_m_university_college_station,accept,31
328,168,160,110.0,3.38,30,3,texas_a_m_university_college_station,accept,31
309,157,152,98.0,2.95,40,0,texas_a_m_university_college_station,accept,31
318,169,149,103.0,3.5,18,0,texas_a_m_university_college_station,accept,31
313,169,144,75.0,3.91,0,0,texas_a_m_university_college_station,accept,31
322,167,155,111.0,3.35,42,0,texas_a_m_university_college_station,accept,31
316,168,148,110.0,3.92,15,0,texas_a_m_university_college_station,accept,31
318,168,150,108.0,3.45,0,0,texas_a_m_university_college_station,accept,31
324,169,155,107.0,3.27,20,0,texas_a_m_university_college_station,accept,31
326,166,160,112.0,3.84,13,3,texas_a_m_university_college_station,accept,31
323,166,157,110.0,3.42,3,3,texas_a_m_university_college_station,accept,31
327,170,157,0,3.45,40,3,texas_a_m_university_college_station,accept,31
331,170,161,117.0,3.9,18,0,texas_a_m_university_college_station,accept,31
322,170,152,105.0,3.17,25,2,texas_a_m_university_college_station,accept,31
324,170,154,112.0,3.31,57,0,texas_a_m_university_college_station,accept,31
324,167,157,115.0,3.86,0,0,texas_a_m_university_college_station,accept,31
322,166,156,110.0,3.34,20,0,texas_a_m_university_college_station,accept,31
334,170,164,111.0,3.63,7,3,texas_a_m_university_college_station,accept,31
328,168,160,110.0,3.38,30,3,texas_a_m_university_college_station,accept,31
309,157,152,98.0,2.95,40,0,texas_a_m_university_college_station,accept,31
318,169,149,103.0,3.5,18,0,texas_a_m_university_college_station,accept,31
322,170,152,104.0,3.4,28,3,texas_a_m_university_college_station,accept,31
322,170,152,104.0,3.4,28,3,texas_a_m_university_college_station,accept,31
325,170,155,107.0,3.7,26,0,texas_a_m_university_college_station,accept,31
324,169,155,109.0,3.33,21,3,texas_a_m_university_college_station,accept,31
320,168,152,104.0,3.8,1,0,texas_a_m_university_college_station,accept,31
324,168,156,103.0,3.5,20,0,texas_a_m_university_college_station,accept,31
328,168,160,112.0,3.54,19,0,texas_a_m_university_college_station,accept,31
324,170,154,106.0,3.44,10,0,texas_a_m_university_college_station,accept,31
324,169,155,101.0,3.38,30,3,texas_a_m_university_college_station,accept,31
319,167,152,113.0,3.39,14,0,texas_a_m_university_college_station,accept,31
329,169,160,112.0,3.28,6,3,texas_a_m_university_college_station,accept,31
331,167,164,112.0,3.44,5,0,texas_a_m_university_college_station,accept,31
317,166,151,103.0,3.6,30,0,texas_a_m_university_college_station,accept,31
324,169,155,105.0,3.65,6,3,texas_a_m_university_college_station,accept,31
323,167,156,107.0,3.68,20,0,texas_a_m_university_college_station,accept,31
329,169,160,108.0,3.51,21,0,texas_a_m_university_college_station,accept,31
325,170,155,110.0,3.44,33,0,texas_a_m_university_college_station,accept,31
340,170,170,116.0,3.46,2,2,texas_a_m_university_college_station,accept,31
321,166,155,106.0,3.56,5,0,texas_a_m_university_college_station,accept,31
325,168,157,113.0,3.44,17,3,texas_a_m_university_college_station,accept,31
330,170,160,108.0,3.6,20,3,texas_a_m_university_college_station,accept,31
322,169,153,112.0,3.88,20,3,texas_a_m_university_college_station,accept,31
322,169,153,112.0,3.88,20,3,texas_a_m_university_college_station,accept,31
317,170,147,99.0,3.28,7,0,texas_a_m_university_college_station,accept,31
319,168,151,106.0,3.39,0,0,texas_a_m_university_college_station,accept,31
325,169,156,115.0,3.67,15,0,texas_a_m_university_college_station,accept,31
318,168,150,110.0,3.5,17,3,texas_a_m_university_college_station,accept,31
332,168,164,116.0,3.75,0,0,texas_a_m_university_college_station,accept,31
333,170,163,112.0,3.34,52,0,texas_a_m_university_college_station,accept,31
319,168,151,102.0,3.36,0,3,texas_a_m_university_college_station,accept,31
322,170,152,107.0,3.25,0,2,texas_a_m_university_college_station,accept,31
323,170,153,108.0,3.53,15,3,texas_a_m_university_college_station,accept,31
309,154,155,95.0,2.76,1,0,texas_a_m_university_college_station,accept,31
326,162,164,111.0,2.76,1,0,texas_a_m_university_college_station,accept,31
322,168,154,112.0,3.46,0,0,texas_a_m_university_college_station,accept,31
322,169,153,118.0,3.56,10,0,texas_a_m_university_college_station,accept,31
319,170,149,104.0,3.24,34,0,texas_a_m_university_college_station,accept,31
330,170,160,111.0,3.32,28,0,texas_a_m_university_college_station,accept,31
320,170,150,100.0,3.39,17,0,texas_a_m_university_college_station,accept,31
326,170,156,102.0,3.02,0,0,texas_a_m_university_college_station,accept,31
323,166,157,114.0,3.64,20,3,texas_a_m_university_college_station,accept,31
323,166,157,114.0,3.64,20,3,texas_a_m_university_college_station,accept,31
325,167,158,112.0,3.28,41,0,texas_a_m_university_college_station,accept,31
323,168,155,0,2.97,33,3,texas_a_m_university_college_station,accept,31
324,168,156,112.0,3.26,14,0,texas_a_m_university_college_station,accept,31
334,169,165,0,3.11,6,0,texas_a_m_university_college_station,accept,31
307,163,144,101,3.0,0,3,texas_a_m_university_college_station,accept,31
320,168,152,106.0,3.65,38,0,texas_a_m_university_college_station,accept,31
326,170,156,0,3.42,8,3,texas_a_m_university_college_station,accept,31
322,167,155,107.0,3.28,15,0,texas_a_m_university_college_station,accept,31
303,163,140,111.0,2.6,0,0,texas_a_m_university_college_station,accept,31
318,169,149,102.0,3.18,15,3,texas_a_m_university_college_station,accept,31
326,170,156,101.0,3.48,19,3,texas_a_m_university_college_station,accept,31
324,170,154,112.0,3.57,46,0,texas_a_m_university_college_station,accept,31
326,169,157,0,3.6,17,0,texas_a_m_university_college_station,accept,31
320,168,152,111.0,3.28,0,0,texas_a_m_university_college_station,accept,31
321,170,151,111.0,3.22,30,0,texas_a_m_university_college_station,accept,31
322,166,156,107.0,3.44,60,3,texas_a_m_university_college_station,accept,31
320,168,152,109.0,3.54,30,0,texas_a_m_university_college_station,accept,31
329,170,159,0,3.4,0,0,texas_a_m_university_college_station,accept,31
329,170,159,0,3.4,0,0,texas_a_m_university_college_station,accept,31
325,168,157,113.0,3.24,32,3,texas_a_m_university_college_station,accept,31
321,167,154,104.0,3.3,19,3,texas_a_m_university_college_station,accept,31
325,170,155,107.0,3.66,8,3,texas_a_m_university_college_station,accept,31
329,170,159,104.0,3.32,43,0,texas_a_m_university_college_station,accept,31
319,166,153,112.0,3.42,4,0,texas_a_m_university_college_station,accept,31
320,169,151,104.0,3.17,31,0,texas_a_m_university_college_station,accept,31
310,160,150,113.0,3.8,27,0,texas_a_m_university_college_station,accept,31
321,167,154,105.0,3.78,40,0,texas_a_m_university_college_station,accept,31
320,165,155,110.0,3.47,36,3,texas_a_m_university_college_station,accept,31
316,168,148,101.0,3.62,19,3,texas_a_m_university_college_station,accept,31
321,169,152,109.0,3.79,24,0,texas_a_m_university_college_station,accept,31
327,168,159,110.0,3.42,2,2,texas_a_m_university_college_station,accept,31
330,164,166,116.0,3.17,21,3,texas_a_m_university_college_station,accept,31
326,170,156,101.0,3.47,8,0,texas_a_m_university_college_station,accept,31
320,167,153,111.0,3.85,47,0,texas_a_m_university_college_station,accept,31
320,167,153,111.0,3.85,47,0,texas_a_m_university_college_station,accept,31
329,167,162,109.0,3.62,2,0,texas_a_m_university_college_station,accept,31
327,170,157,112.0,3.32,16,0,texas_a_m_university_college_station,accept,31
333,170,163,119.0,3.33,24,0,texas_a_m_university_college_station,accept,31
321,168,153,102.0,3.72,24,0,texas_a_m_university_college_station,accept,31
322,170,152,104.0,3.26,46,3,texas_a_m_university_college_station,accept,31
326,164,162,101.0,3.41,1,0,texas_a_m_university_college_station,accept,31
328,169,159,108.0,3.73,24,0,texas_a_m_university_college_station,accept,31
318,170,148,113.0,3.2,12,0,texas_a_m_university_college_station,accept,31
333,170,163,113.0,3.48,5,0,texas_a_m_university_college_station,accept,31
324,170,154,110.0,3.2,41,3,texas_a_m_university_college_station,accept,31
319,170,149,110.0,3.84,21,0,texas_a_m_university_college_station,accept,31
324,168,156,111.0,3.32,15,3,texas_a_m_university_college_station,accept,31
320,167,153,110.0,3.8,24,3,texas_a_m_university_college_station,accept,31
325,170,155,116.0,3.4,30,0,texas_a_m_university_college_station,accept,31
319,168,151,101.0,3.6,20,3,texas_a_m_university_college_station,accept,31
322,169,153,106.0,3.21,1,3,texas_a_m_university_college_station,accept,31
325,165,160,114.0,3.48,25,0,texas_a_m_university_college_station,accept,31
319,152,167,107.0,3.03,1,3,texas_a_m_university_college_station,accept,31
320,167,153,103.0,3.28,18,0,texas_a_m_university_college_station,accept,31
326,168,158,107.0,3.21,25,3,texas_a_m_university_college_station,accept,31
326,168,158,107.0,3.21,25,3,texas_a_m_university_college_station,accept,31
322,168,154,102.0,2.5,2,0,texas_a_m_university_college_station,accept,31
319,167,152,110.0,3.8,16,3,texas_a_m_university_college_station,accept,31
329,170,159,110.0,3.72,19,3,texas_a_m_university_college_station,accept,31
327,170,157,112.0,2.5,35,3,texas_a_m_university_college_station,accept,31
327,170,157,112.0,3.05,40,0,texas_a_m_university_college_station,accept,31
332,170,162,113.0,3.6,1,0,texas_a_m_university_college_station,accept,31
319,167,152,115.0,3.38,0,0,texas_a_m_university_college_station,accept,31
319,163,156,103.0,3.4,0,2,texas_a_m_university_college_station,accept,31
330,165,165,116.0,3.82,0,0,texas_a_m_university_college_station,accept,31
325,168,157,118.0,3.32,17,0,texas_a_m_university_college_station,accept,31
317,165,152,107.0,3.56,0,0,texas_a_m_university_college_station,accept,31
313,160,153,103.0,3.68,18,3,texas_a_m_university_college_station,accept,31
321,170,151,103.0,3.3,0,0,texas_a_m_university_college_station,accept,31
324,168,156,108.0,3.6,70,3,texas_a_m_university_college_station,accept,31
324,167,157,112.0,3.4,20,0,texas_a_m_university_college_station,accept,31
325,170,155,111.0,3.94,30,2,texas_a_m_university_college_station,accept,31
316,167,149,103.0,3.76,30,0,texas_a_m_university_college_station,accept,31
326,169,157,101,3.68,48,3,texas_a_m_university_college_station,accept,31
325,170,155,110.0,3.07,42,0,texas_a_m_university_college_station,accept,31
321,170,151,96.0,3.64,24,3,texas_a_m_university_college_station,accept,31
321,170,151,96.0,3.64,24,3,texas_a_m_university_college_station,accept,31
313,155,158,106.0,2.23,0,0,texas_a_m_university_college_station,accept,31
312,162,150,106.0,1.7,30,0,texas_a_m_university_college_station,accept,31
318,160,158,109.0,3.29,0,0,texas_a_m_university_college_station,accept,31
329,170,159,108.0,3.1,30,3,texas_a_m_university_college_station,accept,31
320,168,152,100.0,3.07,0,3,texas_a_m_university_college_station,accept,31
323,170,153,114.0,3.0,0,1,texas_a_m_university_college_station,accept,31
329,170,159,114.0,3.24,0,0,texas_a_m_university_college_station,accept,31
318,164,154,109.0,3.42,30,0,texas_a_m_university_college_station,accept,31
333,168,165,118.0,3.65,10,0,texas_a_m_university_college_station,accept,31
326,167,159,107.0,3.51,0,3,texas_a_m_university_college_station,accept,31
323,169,154,104.0,3.38,0,0,texas_a_m_university_college_station,accept,31
322,169,153,103.0,3.37,0,0,texas_a_m_university_college_station,accept,31
330,167,163,113.0,3.2,0,0,texas_a_m_university_college_station,accept,31
323,166,157,112.0,3.54,18,3,texas_a_m_university_college_station,reject,31
323,166,157,112.0,3.54,18,3,texas_a_m_university_college_station,reject,31
327,166,161,108.0,3.18,10,3,texas_a_m_university_college_station,reject,31
318,165,153,103.0,3.44,27,0,texas_a_m_university_college_station,reject,31
322,163,159,115.0,2.4,22,3,texas_a_m_university_college_station,reject,31
310,160,150,101,3.56,16,2,texas_a_m_university_college_station,reject,31
315,168,147,102.0,3.04,35,0,texas_a_m_university_college_station,reject,31
319,165,154,101,3.2,51,0,texas_a_m_university_college_station,reject,31
313,158,155,100.0,2.91,12,0,texas_a_m_university_college_station,reject,31
307,165,142,93.0,3.33,29,0,texas_a_m_university_college_station,reject,31
310,166,144,91.0,3.3,23,0,texas_a_m_university_college_station,reject,31
317,164,153,101.0,3.71,50,0,texas_a_m_university_college_station,reject,31
316,163,153,109.0,3.49,26,3,texas_a_m_university_college_station,reject,31
320,168,152,109.0,3.18,16,0,texas_a_m_university_college_station,reject,31
329,166,163,107.0,3.47,15,3,texas_a_m_university_college_station,reject,31
323,168,155,109.0,3.19,24,3,texas_a_m_university_college_station,reject,31
317,166,151,105.0,3.23,8,0,texas_a_m_university_college_station,reject,31
324,167,157,111.0,2.85,40,1,texas_a_m_university_college_station,reject,31
320,168,152,99.0,3.08,13,0,texas_a_m_university_college_station,reject,31
327,170,157,108.0,3.4,12,0,texas_a_m_university_college_station,reject,31
323,166,157,112.0,3.54,18,3,texas_a_m_university_college_station,reject,31
323,166,157,112.0,3.54,18,3,texas_a_m_university_college_station,reject,31
327,166,161,108.0,3.18,10,3,texas_a_m_university_college_station,reject,31
318,165,153,103.0,3.44,27,0,texas_a_m_university_college_station,reject,31
322,163,159,115.0,2.4,22,3,texas_a_m_university_college_station,reject,31
310,160,150,101,3.56,16,2,texas_a_m_university_college_station,reject,31
315,168,147,102.0,3.04,35,0,texas_a_m_university_college_station,reject,31
319,165,154,101,3.2,51,0,texas_a_m_university_college_station,reject,31
313,158,155,100.0,2.91,12,0,texas_a_m_university_college_station,reject,31
307,165,142,93.0,3.33,29,0,texas_a_m_university_college_station,reject,31
310,166,144,91.0,3.3,23,0,texas_a_m_university_college_station,reject,31
317,164,153,101.0,3.71,50,0,texas_a_m_university_college_station,reject,31
316,163,153,109.0,3.49,26,3,texas_a_m_university_college_station,reject,31
320,168,152,109.0,3.18,16,0,texas_a_m_university_college_station,reject,31
329,166,163,107.0,3.47,15,3,texas_a_m_university_college_station,reject,31
323,168,155,109.0,3.19,24,3,texas_a_m_university_college_station,reject,31
317,166,151,105.0,3.23,8,0,texas_a_m_university_college_station,reject,31
324,167,157,111.0,2.85,40,1,texas_a_m_university_college_station,reject,31
320,168,152,99.0,3.08,13,0,texas_a_m_university_college_station,reject,31
327,170,157,108.0,3.4,12,0,texas_a_m_university_college_station,reject,31
329,168,161,113.0,3.06,40,0,texas_a_m_university_college_station,reject,31
329,168,161,113.0,3.06,40,0,texas_a_m_university_college_station,reject,31
326,170,156,108.0,3.59,26,0,texas_a_m_university_college_station,reject,31
305,157,148,88.0,3.6,48,0,texas_a_m_university_college_station,reject,31
321,167,154,112.0,3.44,37,0,texas_a_m_university_college_station,reject,31
322,166,156,103.0,2.25,8,3,texas_a_m_university_college_station,reject,31
316,161,155,114.0,3.34,0,0,texas_a_m_university_college_station,reject,31
328,169,159,106.0,3.67,6,0,texas_a_m_university_college_station,reject,31
313,159,154,103.0,3.3,48,0,texas_a_m_university_college_station,reject,31
320,165,155,101.0,2.51,1,0,texas_a_m_university_college_station,reject,31
314,166,148,101.0,2.83,24,0,texas_a_m_university_college_station,reject,31
322,160,162,105.0,3.6,0,2,texas_a_m_university_college_station,reject,31
325,167,158,109.0,3.06,0,0,texas_a_m_university_college_station,reject,31
318,168,150,107.0,3.27,1,0,texas_a_m_university_college_station,reject,31
311,162,149,102.0,2.45,0,3,texas_a_m_university_college_station,reject,31
323,170,153,119.0,3.25,0,0,texas_a_m_university_college_station,reject,31
316,164,152,101.0,1.95,14,2,texas_a_m_university_college_station,reject,31
329,170,159,109.0,3.04,20,0,texas_a_m_university_college_station,reject,31
315,163,152,103.0,3.24,13,0,texas_a_m_university_college_station,reject,31
324,169,155,112.0,3.16,15,3,texas_a_m_university_college_station,reject,31
324,169,155,112.0,3.16,15,3,texas_a_m_university_college_station,reject,31
310,161,149,106.0,3.26,36,0,texas_a_m_university_college_station,reject,31
319,167,152,109.0,3.28,7,0,texas_a_m_university_college_station,reject,31
319,167,152,107.0,3.44,0,0,texas_a_m_university_college_station,reject,31
321,165,156,105.0,3.0,39,0,texas_a_m_university_college_station,reject,31
332,162,170,114.0,3.28,34,0,texas_a_m_university_college_station,reject,31
322,167,155,107.0,2.21,0,0,texas_a_m_university_college_station,reject,31
325,168,157,116.0,3.72,23,3,texas_a_m_university_college_station,reject,31
305,160,145,104.0,3.31,20,0,texas_a_m_university_college_station,reject,31
321,162,159,115.0,2.74,33,0,texas_a_m_university_college_station,reject,31
304,160,144,91.0,3.39,60,3,texas_a_m_university_college_station,reject,31
311,163,148,101.0,3.0,39,0,texas_a_m_university_college_station,reject,31
308,158,150,101.0,3.38,28,0,texas_a_m_university_college_station,reject,31
314,164,150,92.0,2.6,18,0,texas_a_m_university_college_station,reject,31
317,164,153,102.0,2.5,6,1,texas_a_m_university_college_station,reject,31
327,164,163,115.0,2.5,0,0,texas_a_m_university_college_station,reject,31
324,167,157,111.0,2.66,40,0,texas_a_m_university_college_station,reject,31
319,168,151,106.0,3.3,34,0,texas_a_m_university_college_station,reject,31
317,164,153,107.0,3.36,18,0,texas_a_m_university_college_station,reject,31
317,164,153,107.0,3.36,18,0,texas_a_m_university_college_station,reject,31
322,170,152,108.0,3.25,0,0,texas_a_m_university_college_station,reject,31
312,162,150,110.0,3.44,19,0,texas_a_m_university_college_station,reject,31
321,167,154,100.0,3.55,33,2,texas_a_m_university_college_station,reject,31
322,161,161,109.0,2.9,7,1,texas_a_m_university_college_station,reject,31
307,161,146,112.0,3.53,36,3,texas_a_m_university_college_station,reject,31
323,164,159,108.0,3.48,3,0,texas_a_m_university_college_station,reject,31
324,163,161,0,3.08,34,0,texas_a_m_university_college_station,reject,31
304,162,142,98.0,3.43,5,3,texas_a_m_university_college_station,reject,31
321,164,157,118.0,3.57,16,3,texas_a_m_university_college_station,reject,31
318,167,151,90.0,3.44,30,0,texas_a_m_university_college_station,reject,31
319,163,156,108.0,2.8,48,0,texas_a_m_university_college_station,reject,31
304,154,150,105.0,3.2,31,3,texas_a_m_university_college_station,reject,31
324,164,160,116.0,2.95,48,2,texas_a_m_university_college_station,reject,31
322,170,152,107.0,3.56,39,0,texas_a_m_university_college_station,reject,31
321,164,157,111.0,3.71,18,3,texas_a_m_university_college_station,reject,31
318,166,152,104.0,3.44,40,0,texas_a_m_university_college_station,reject,31
334,170,164,0,3.26,14,0,texas_a_m_university_college_station,reject,31
331,170,161,0,3.62,21,3,texas_a_m_university_college_station,reject,31
311,165,146,104.0,3.32,47,0,texas_a_m_university_college_station,reject,31
311,165,146,104.0,3.32,47,0,texas_a_m_university_college_station,reject,31
312,162,150,113.0,3.74,4,3,texas_a_m_university_college_station,reject,31
314,166,148,100.0,3.66,11,3,texas_a_m_university_college_station,reject,31
317,165,152,102.0,3.09,13,0,texas_a_m_university_college_station,reject,31
317,168,149,104.0,2.84,3,0,texas_a_m_university_college_station,reject,31
326,168,158,0,3.22,1,3,texas_a_m_university_college_station,reject,31
317,164,153,93.0,3.22,20,3,texas_a_m_university_college_station,reject,31
316,169,147,107.0,2.84,40,0,texas_a_m_university_college_station,reject,31
322,164,158,111.0,3.42,60,0,texas_a_m_university_college_station,reject,31
325,170,155,106.0,2.59,31,0,texas_a_m_university_college_station,reject,31
318,168,150,102.0,3.06,29,0,texas_a_m_university_college_station,reject,31
310,159,151,103.0,3.18,39,0,texas_a_m_university_college_station,reject,31
314,164,150,0,3.24,20,0,texas_a_m_university_college_station,reject,31
321,166,155,0,3.43,36,0,texas_a_m_university_college_station,reject,31
321,167,154,110.0,3.05,18,0,texas_a_m_university_college_station,reject,31
311,161,150,109.0,1.48,3,0,texas_a_m_university_college_station,reject,31
319,165,154,110.0,3.49,24,3,texas_a_m_university_college_station,reject,31
321,170,151,103.0,3.12,22,3,texas_a_m_university_college_station,reject,31
322,170,152,101.0,2.25,8,1,texas_a_m_university_college_station,reject,31
312,163,149,87.0,2.81,30,1,texas_a_m_university_college_station,reject,31
321,167,154,113.0,3.54,2,2,texas_a_m_university_college_station,reject,31
321,167,154,113.0,3.54,2,2,texas_a_m_university_college_station,reject,31
316,163,153,104.0,3.24,48,0,texas_a_m_university_college_station,reject,31
323,168,155,108.0,3.6,33,0,texas_a_m_university_college_station,reject,31
324,166,158,106.0,3.2,26,0,texas_a_m_university_college_station,reject,31
320,164,156,75.0,3.4,1,0,texas_a_m_university_college_station,reject,31
315,170,145,103.0,3.47,19,0,texas_a_m_university_college_station,reject,31
325,170,155,114.0,3.24,0,0,texas_a_m_university_college_station,reject,31
335,170,165,109.0,3.42,42,0,texas_a_m_university_college_station,reject,31
315,162,153,108.0,3.39,18,0,texas_a_m_university_college_station,reject,31
321,167,154,114.0,3.57,20,3,texas_a_m_university_college_station,reject,31
326,169,157,112.0,3.17,0,0,texas_a_m_university_college_station,reject,31
309,164,145,99.0,2.69,3,3,texas_a_m_university_college_station,reject,31
310,164,146,104.0,2.92,28,0,texas_a_m_university_college_station,reject,31
324,167,157,112.0,2.74,15,3,texas_a_m_university_college_station,reject,31
317,166,151,110.0,3.56,21,2,texas_a_m_university_college_station,reject,31
312,164,148,97.0,3.65,27,3,texas_a_m_university_college_station,reject,31
322,168,154,104.0,3.76,40,0,texas_a_m_university_college_station,reject,31
320,162,158,107.0,2.7,28,0,texas_a_m_university_college_station,reject,31
310,158,152,107.0,3.36,21,0,texas_a_m_university_college_station,reject,31
317,167,150,98.0,3.21,5,3,texas_a_m_university_college_station,reject,31
319,163,156,109.0,3.29,32,0,texas_a_m_university_college_station,reject,31
319,163,156,109.0,3.29,32,0,texas_a_m_university_college_station,reject,31
327,170,157,118.0,3.62,16,0,texas_a_m_university_college_station,reject,31
323,170,153,105.0,3.28,20,3,texas_a_m_university_college_station,reject,31
329,170,159,116.0,3.64,10,3,texas_a_m_university_college_station,reject,31
318,165,153,108.0,3.41,0,0,texas_a_m_university_college_station,reject,31
302,153,149,102.0,2.75,6,0,texas_a_m_university_college_station,reject,31
314,161,153,0,3.55,24,3,texas_a_m_university_college_station,reject,31
319,167,152,103.0,3.22,15,0,texas_a_m_university_college_station,reject,31
320,169,151,75.0,3.4,17,0,texas_a_m_university_college_station,reject,31
320,165,155,0,2.7,22,3,texas_a_m_university_college_station,reject,31
314,162,152,106.0,3.36,6,0,texas_a_m_university_college_station,reject,31
319,169,150,0,3.34,9,0,texas_a_m_university_college_station,reject,31
317,162,155,0,3.2,34,0,texas_a_m_university_college_station,reject,31
309,157,152,117.0,2.5,12,0,texas_a_m_university_college_station,reject,31
329,167,162,110.0,3.09,31,0,texas_a_m_university_college_station,reject,31
321,165,156,110.0,3.6,36,0,texas_a_m_university_college_station,reject,31
322,165,157,104.0,2.9,20,0,texas_a_m_university_college_station,reject,31
306,163,143,90.0,2.3,24,0,texas_a_m_university_college_station,reject,31
307,161,146,95.0,3.71,0,0,texas_a_m_university_college_station,reject,31
309,159,150,94.0,3.56,37,0,texas_a_m_university_college_station,reject,31
309,159,150,94.0,3.56,37,0,texas_a_m_university_college_station,reject,31
316,168,148,87.0,2.11,11,2,texas_a_m_university_college_station,reject,31
326,162,164,110.0,3.25,28,3,texas_a_m_university_college_station,reject,31
311,166,145,103.0,3.18,0,0,texas_a_m_university_college_station,reject,31
312,157,155,106.0,3.44,47,0,texas_a_m_university_college_station,reject,31
319,164,155,108.0,2.71,51,0,texas_a_m_university_college_station,reject,31
312,167,145,100.0,3.38,31,0,texas_a_m_university_college_station,reject,31
316,163,153,107.0,2.48,18,0,texas_a_m_university_college_station,reject,31
319,164,155,103.0,2.98,3,0,texas_a_m_university_college_station,reject,31
325,164,161,116.0,2.98,19,0,texas_a_m_university_college_station,reject,31
327,165,162,117.0,3.74,18,3,texas_a_m_university_college_station,reject,31
309,161,148,99.0,2.37,16,0,texas_a_m_university_college_station,reject,31
310,161,149,101,2.96,40,0,texas_a_m_university_college_station,reject,31
315,168,147,90.0,3.25,54,2,texas_a_m_university_college_station,reject,31
314,161,153,104.0,2.71,20,0,texas_a_m_university_college_station,reject,31
316,164,152,109.0,3.34,18,0,texas_a_m_university_college_station,reject,31
311,170,141,91.0,3.08,0,0,texas_a_m_university_college_station,reject,31
318,169,149,103.0,3.48,7,0,texas_a_m_university_college_station,reject,31
310,164,146,96.0,3.47,21,0,texas_a_m_university_college_station,reject,31
321,164,157,117.0,3.29,19,3,texas_a_m_university_college_station,reject,31
321,164,157,117.0,3.29,19,3,texas_a_m_university_college_station,reject,31
327,170,157,107.0,3.16,16,0,texas_a_m_university_college_station,reject,31
329,170,159,111.0,2.81,5,0,texas_a_m_university_college_station,reject,31
317,168,149,109.0,3.08,36,0,texas_a_m_university_college_station,reject,31
313,163,150,98.0,2.85,153,3,texas_a_m_university_college_station,reject,31
323,170,153,95.0,2.8,61,0,texas_a_m_university_college_station,reject,31
311,161,150,100.0,2.34,41,0,texas_a_m_university_college_station,reject,31
313,163,150,104.0,2.15,74,0,texas_a_m_university_college_station,reject,31
325,164,161,117.0,3.75,17,3,texas_a_m_university_college_station,reject,31
323,168,155,110.0,3.24,17,0,texas_a_m_university_college_station,reject,31
326,170,156,101.0,3.02,0,0,texas_a_m_university_college_station,reject,31
326,170,156,110.0,3.28,4,0,texas_a_m_university_college_station,reject,31
325,164,161,114.0,2.95,24,0,texas_a_m_university_college_station,reject,31
314,161,153,111.0,3.75,26,0,texas_a_m_university_college_station,reject,31
329,166,163,113.0,2.86,30,0,texas_a_m_university_college_station,reject,31
322,165,157,94.0,3.28,20,0,texas_a_m_university_college_station,reject,31
329,170,159,111.0,3.66,4,0,texas_a_m_university_college_station,reject,31
311,162,149,80.0,3.63,0,3,texas_a_m_university_college_station,reject,31
314,168,146,103.0,3.59,0,0,texas_a_m_university_college_station,reject,31
316,162,154,115.0,3.72,6,3,texas_a_m_university_college_station,reject,31
316,162,154,115.0,3.72,6,3,texas_a_m_university_college_station,reject,31
330,167,163,116.0,3.52,18,0,texas_a_m_university_college_station,reject,31
317,162,155,110.0,3.17,5,3,texas_a_m_university_college_station,reject,31
322,163,159,110.0,3.25,30,0,texas_a_m_university_college_station,reject,31
314,162,152,100.0,2.8,35,0,texas_a_m_university_college_station,reject,31
312,163,149,106.0,3.42,0,0,texas_a_m_university_college_station,reject,31
318,167,151,104.0,3.42,25,0,texas_a_m_university_college_station,reject,31
313,165,148,102.0,3.66,24,3,texas_a_m_university_college_station,reject,31
324,167,157,117.0,3.75,0,0,texas_a_m_university_college_station,reject,31
308,162,146,89.0,3.12,21,0,texas_a_m_university_college_station,reject,31
308,161,147,97.0,3.0,40,0,texas_a_m_university_college_station,reject,31
326,170,156,115.0,3.39,6,1,texas_a_m_university_college_station,reject,31
320,167,153,106.0,3.55,40,3,texas_a_m_university_college_station,reject,31
316,167,149,104.0,3.48,15,0,texas_a_m_university_college_station,reject,31
314,162,152,104.0,3.05,17,0,texas_a_m_university_college_station,reject,31
310,168,142,101.0,2.76,42,3,texas_a_m_university_college_station,reject,31
304,159,145,102.0,2.75,36,0,texas_a_m_university_college_station,reject,31
320,168,152,94.0,3.21,13,0,texas_a_m_university_college_station,reject,31
329,168,161,111.0,1.95,1,0,texas_a_m_university_college_station,reject,31
321,167,154,111.0,2.57,22,0,texas_a_m_university_college_station,reject,31
317,168,149,105.0,2.9,25,0,university_of_connecticut,accept,70
317,168,149,105.0,2.9,25,0,university_of_connecticut,accept,70
319,163,156,110.0,2.88,2,0,university_of_connecticut,accept,70
315,164,151,107.0,3.31,29,0,university_of_connecticut,accept,70
314,164,150,0,3.24,20,0,university_of_connecticut,accept,70
316,163,153,88.0,3.67,0,0,university_of_connecticut,accept,70
307,161,146,92.0,2.61,42,0,university_of_connecticut,accept,70
303,162,141,91.0,3.07,17,0,university_of_connecticut,accept,70
314,167,147,101.0,3.26,15,0,university_of_connecticut,accept,70
311,165,146,95.0,2.72,0,0,university_of_connecticut,accept,70
311,161,150,98.0,2.69,0,0,university_of_connecticut,accept,70
313,162,151,101.0,2.73,0,0,university_of_connecticut,accept,70
309,163,146,102.0,2.55,30,3,university_of_connecticut,accept,70
306,158,148,104.0,2.5,30,0,university_of_connecticut,accept,70
314,163,151,99.0,2.49,0,0,university_of_connecticut,accept,70
306,159,147,107.0,3.36,0,3,university_of_connecticut,accept,70
317,163,154,107.0,2.8,18,0,university_of_connecticut,accept,70
300,156,144,100.0,3.34,30,3,university_of_connecticut,accept,70
310,166,144,92.0,3.44,0,0,university_of_connecticut,accept,70
317,168,149,105.0,2.9,25,0,university_of_connecticut,accept,70
317,168,149,105.0,2.9,25,0,university_of_connecticut,accept,70
319,163,156,110.0,2.88,2,0,university_of_connecticut,accept,70
315,164,151,107.0,3.31,29,0,university_of_connecticut,accept,70
314,164,150,0,3.24,20,0,university_of_connecticut,accept,70
316,163,153,88.0,3.67,0,0,university_of_connecticut,accept,70
307,161,146,92.0,2.61,42,0,university_of_connecticut,accept,70
303,162,141,91.0,3.07,17,0,university_of_connecticut,accept,70
314,167,147,101.0,3.26,15,0,university_of_connecticut,accept,70
311,165,146,95.0,2.72,0,0,university_of_connecticut,accept,70
311,161,150,98.0,2.69,0,0,university_of_connecticut,accept,70
313,162,151,101.0,2.73,0,0,university_of_connecticut,accept,70
309,163,146,102.0,2.55,30,3,university_of_connecticut,accept,70
306,158,148,104.0,2.5,30,0,university_of_connecticut,accept,70
314,163,151,99.0,2.49,0,0,university_of_connecticut,accept,70
306,159,147,107.0,3.36,0,3,university_of_connecticut,accept,70
317,163,154,107.0,2.8,18,0,university_of_connecticut,accept,70
300,156,144,100.0,3.34,30,3,university_of_connecticut,accept,70
310,166,144,92.0,3.44,0,0,university_of_connecticut,accept,70
314,165,149,102.0,2.65,33,0,university_of_connecticut,reject,70
314,165,149,102.0,2.65,33,0,university_of_connecticut,reject,70
295,152,143,83.0,2.23,21,3,university_of_connecticut,reject,70
314,165,149,0,2.95,6,0,university_of_connecticut,reject,70
310,166,144,114,2.42,0,0,university_of_connecticut,reject,70
301,156,145,65.0,2.78,3,0,university_of_connecticut,reject,70
307,159,148,99.0,2.94,4,3,university_of_connecticut,reject,70
308,158,150,75.0,2.95,22,0,university_of_connecticut,reject,70
304,155,149,84.0,2.09,36,3,university_of_connecticut,reject,70
309,161,148,89.0,2.1,17,2,university_of_connecticut,reject,70
314,157,157,111.0,3.21,0,0,university_of_connecticut,reject,70
307,161,146,97.0,3.75,20,1,university_of_connecticut,reject,70
302,153,149,99.0,2.13,36,0,university_of_connecticut,reject,70
313,159,154,113.0,3.46,24,0,university_of_connecticut,reject,70
309,166,143,89.0,2.15,23,0,university_of_connecticut,reject,70
315,162,153,107.0,1.9,42,0,university_of_connecticut,reject,70
307,161,146,99.0,3.0,0,0,university_of_connecticut,reject,70
298,154,144,78,2.8,30,0,university_of_connecticut,reject,70
309,159,150,104.0,2.92,30,0,university_of_connecticut,reject,70
300,151,149,104.0,3.38,10,0,university_of_connecticut,reject,70
310,162,148,65.0,3.3,24,0,university_of_connecticut,reject,70
310,162,148,65.0,3.3,24,0,university_of_connecticut,reject,70
307,161,146,105.0,2.95,8,0,university_of_connecticut,reject,70
320,160,160,112.0,2.25,50,1,university_of_connecticut,reject,70
311,162,149,104.0,3.2,30,0,university_of_connecticut,reject,70
299,158,141,65.0,3.27,0,0,university_of_connecticut,reject,70
322,167,155,107.0,3.54,0,0,university_of_colorado_boulder,accept,58
322,167,155,107.0,3.54,0,0,university_of_colorado_boulder,accept,58
304,161,143,100.0,3.88,28,3,university_of_colorado_boulder,accept,58
317,166,151,114,3.48,1,0,university_of_colorado_boulder,accept,58
318,168,150,106.0,3.4,0,0,university_of_colorado_boulder,accept,58
335,170,165,115.0,3.18,27,0,university_of_colorado_boulder,accept,58
318,162,156,108.0,3.8,20,3,university_of_colorado_boulder,accept,58
310,161,149,98.0,3.66,28,3,university_of_colorado_boulder,accept,58
318,167,151,109.0,3.88,2,0,university_of_colorado_boulder,accept,58
314,150,164,108.0,3.44,11,3,university_of_colorado_boulder,accept,58
313,165,148,94.0,3.53,41,0,university_of_colorado_boulder,accept,58
328,158,170,114.0,3.48,20,3,university_of_colorado_boulder,accept,58
316,164,152,108.0,3.47,11,0,university_of_colorado_boulder,accept,58
318,164,154,105.0,3.59,12,0,university_of_colorado_boulder,accept,58
309,159,150,93.0,3.58,44,0,university_of_colorado_boulder,accept,58
325,167,158,114.0,3.48,1,0,university_of_colorado_boulder,accept,58
322,167,155,107.0,3.54,0,0,university_of_colorado_boulder,accept,58
322,167,155,107.0,3.54,0,0,university_of_colorado_boulder,accept,58
315,163,152,105.0,2.05,33,0,university_of_colorado_boulder,accept,58
317,166,151,114,3.48,1,0,university_of_colorado_boulder,accept,58
318,168,150,106.0,3.4,0,0,university_of_colorado_boulder,accept,58
335,170,165,115.0,3.18,27,0,university_of_colorado_boulder,accept,58
329,166,163,114.0,3.59,40,3,university_of_colorado_boulder,accept,58
310,161,149,98.0,3.66,28,3,university_of_colorado_boulder,accept,58
318,167,151,109.0,3.88,2,0,university_of_colorado_boulder,accept,58
314,150,164,108.0,3.44,11,3,university_of_colorado_boulder,accept,58
314,163,151,102.0,3.68,20,0,university_of_colorado_boulder,accept,58
328,158,170,114.0,3.48,20,3,university_of_colorado_boulder,accept,58
316,164,152,108.0,3.47,11,0,university_of_colorado_boulder,accept,58
318,164,154,105.0,3.59,12,0,university_of_colorado_boulder,accept,58
310,159,151,105.0,3.59,10,0,university_of_colorado_boulder,accept,58
309,159,150,93.0,3.58,44,0,university_of_colorado_boulder,accept,58
325,167,158,114.0,3.48,1,0,university_of_colorado_boulder,accept,58
325,170,155,115.0,3.48,5,0,university_of_colorado_boulder,accept,58
317,166,151,103.0,3.6,43,0,university_of_colorado_boulder,accept,58
322,162,160,109.0,3.52,7,3,university_of_colorado_boulder,accept,58
326,169,157,111.0,3.26,1,3,university_of_colorado_boulder,accept,58
315,166,149,101,3.09,6,0,university_of_colorado_boulder,accept,58
314,162,152,102.0,3.51,38,0,university_of_colorado_boulder,accept,58
322,170,152,111.0,2.9,20,0,university_of_colorado_boulder,accept,58
314,164,150,93.0,2.84,18,0,university_of_colorado_boulder,accept,58
318,167,151,97.0,3.48,11,0,university_of_colorado_boulder,accept,58
313,160,153,110.0,3.49,7,0,university_of_colorado_boulder,accept,58
326,169,157,111.0,3.4,0,0,university_of_colorado_boulder,accept,58
312,162,150,94.0,3.53,60,3,university_of_colorado_boulder,accept,58
321,168,153,104.0,3.36,9,0,university_of_colorado_boulder,accept,58
313,159,154,109.0,3.76,2,0,university_of_colorado_boulder,accept,58
310,158,152,110.0,1.47,14,0,university_of_colorado_boulder,accept,58
324,169,155,116.0,3.42,26,3,university_of_colorado_boulder,accept,58
325,168,157,113.0,3.15,45,3,university_of_colorado_boulder,accept,58
311,148,163,108.0,3.64,36,3,university_of_colorado_boulder,accept,58
317,163,154,111.0,3.31,18,3,university_of_colorado_boulder,accept,58
310,160,150,0,3.51,4,0,university_of_colorado_boulder,accept,58
326,169,157,112.0,2.8,13,3,university_of_colorado_boulder,accept,58
311,162,149,96.0,3.38,16,0,university_of_colorado_boulder,accept,58
315,162,153,108.0,3.39,18,0,university_of_colorado_boulder,accept,58
314,161,153,113.0,3.43,3,0,university_of_colorado_boulder,accept,58
326,169,157,0,3.6,17,0,university_of_colorado_boulder,accept,58
317,163,154,111.0,3.66,38,0,university_of_colorado_boulder,accept,58
314,161,153,112.0,2.36,35,3,university_of_colorado_boulder,accept,58
313,161,152,108.0,3.86,28,0,university_of_colorado_boulder,accept,58
321,167,154,114.0,3.08,0,3,university_of_colorado_boulder,accept,58
312,166,146,100.0,3.32,37,0,university_of_colorado_boulder,accept,58
310,160,150,103.0,3.42,36,0,university_of_colorado_boulder,accept,58
310,160,150,103.0,3.42,36,0,university_of_colorado_boulder,accept,58
317,166,151,102.0,3.72,49,0,university_of_colorado_boulder,accept,58
324,167,157,116.0,3.41,6,3,university_of_colorado_boulder,accept,58
326,167,159,112.0,3.67,5,0,university_of_colorado_boulder,accept,58
323,167,156,115.0,3.59,19,0,university_of_colorado_boulder,accept,58
314,159,155,103.0,3.17,36,0,university_of_colorado_boulder,accept,58
327,167,160,114.0,3.57,16,2,university_of_colorado_boulder,accept,58
310,160,150,97.0,3.51,41,0,university_of_colorado_boulder,accept,58
306,154,152,109.0,3.41,0,0,university_of_colorado_boulder,accept,58
322,163,159,113.0,3.52,4,0,university_of_colorado_boulder,accept,58
322,168,154,103.0,3.24,17,0,university_of_colorado_boulder,accept,58
317,162,155,101.0,3.49,24,0,university_of_colorado_boulder,accept,58
307,163,144,92.0,3.36,28,0,university_of_colorado_boulder,accept,58
307,158,149,89.0,3.26,13,0,university_of_colorado_boulder,accept,58
312,160,152,106.0,3.74,31,0,university_of_colorado_boulder,accept,58
317,164,153,107.0,3.47,26,0,university_of_colorado_boulder,accept,58
317,164,153,107.0,3.47,26,0,university_of_colorado_boulder,accept,58
321,164,157,118.0,3.57,16,3,university_of_colorado_boulder,accept,58
321,164,157,111.0,3.71,18,3,university_of_colorado_boulder,accept,58
336,170,166,117.0,3.43,2,0,university_of_colorado_boulder,accept,58
322,166,156,104.0,3.02,36,0,university_of_colorado_boulder,accept,58
325,168,157,116.0,3.72,23,3,university_of_colorado_boulder,accept,58
322,170,152,109.0,3.02,44,3,university_of_colorado_boulder,accept,58
318,165,153,0,3.49,20,3,university_of_colorado_boulder,accept,58
324,166,158,0,3.46,2,0,university_of_colorado_boulder,accept,58
328,169,159,116.0,3.24,29,0,university_of_colorado_boulder,accept,58
330,167,163,110.0,3.66,2,0,university_of_colorado_boulder,accept,58
317,167,150,103.0,3.52,0,3,university_of_colorado_boulder,accept,58
317,167,150,103.0,3.52,0,3,university_of_colorado_boulder,accept,58
330,167,163,115.0,3.88,0,0,university_of_colorado_boulder,accept,58
317,167,150,105.0,3.0,12,3,university_of_colorado_boulder,accept,58
315,161,154,109.0,3.53,0,0,university_of_colorado_boulder,accept,58
327,165,162,117.0,3.74,18,3,university_of_colorado_boulder,accept,58
325,162,163,109.0,3.61,24,0,university_of_colorado_boulder,accept,58
321,166,155,116.0,3.46,10,3,university_of_colorado_boulder,accept,58
320,161,159,114.0,2.9,22,0,university_of_colorado_boulder,accept,58
311,165,146,103.0,3.51,18,0,university_of_colorado_boulder,accept,58
319,160,159,107.0,3.56,8,0,university_of_colorado_boulder,accept,58
318,162,156,108.0,3.26,30,3,university_of_colorado_boulder,accept,58
320,168,152,114,3.22,12,3,university_of_colorado_boulder,accept,58
318,168,150,108.0,3.38,30,0,university_of_colorado_boulder,accept,58
322,170,152,94.0,3.0,16,0,university_of_colorado_boulder,accept,58
322,161,161,111.0,3.63,16,0,university_of_colorado_boulder,accept,58
316,160,156,103.0,3.68,0,0,university_of_colorado_boulder,accept,58
328,168,160,113.0,3.67,7,0,university_of_colorado_boulder,accept,58
316,160,156,102.0,3.15,40,0,university_of_colorado_boulder,accept,58
321,168,153,113.0,3.72,3,0,university_of_colorado_boulder,accept,58
326,170,156,114.0,3.44,14,3,university_of_colorado_boulder,accept,58
327,168,159,114.0,3.51,2,3,university_of_colorado_boulder,accept,58
327,168,159,110.0,3.76,36,0,university_of_colorado_boulder,accept,58
333,170,163,113.0,3.45,20,3,university_of_colorado_boulder,accept,58
306,159,147,93.0,3.2,37,0,university_of_colorado_boulder,accept,58
317,158,159,105.0,3.62,19,0,university_of_colorado_boulder,accept,58
308,159,149,104.0,3.45,3,3,university_of_colorado_boulder,accept,58
332,166,166,118.0,3.37,16,2,university_of_colorado_boulder,accept,58
315,166,149,107.0,3.76,6,0,university_of_colorado_boulder,accept,58
318,167,151,107.0,3.8,0,0,university_of_colorado_boulder,accept,58
308,164,144,103.0,3.63,2,3,university_of_colorado_boulder,accept,58
311,167,144,96.0,3.57,30,0,university_of_colorado_boulder,accept,58
316,162,154,101.0,3.36,6,3,university_of_colorado_boulder,accept,58
319,167,152,99.0,3.0,6,3,university_of_colorado_boulder,accept,58
326,170,156,109.0,3.38,12,3,university_of_colorado_boulder,accept,58
309,164,145,86.0,3.38,33,0,university_of_colorado_boulder,accept,58
319,170,149,110.0,3.43,18,3,university_of_colorado_boulder,accept,58
319,165,154,108.0,3.6,7,0,university_of_colorado_boulder,accept,58
310,164,146,97.0,2.55,22,0,university_of_colorado_boulder,accept,58
315,166,149,102.0,3.44,6,0,university_of_colorado_boulder,accept,58
316,170,146,108.0,3.82,30,3,university_of_colorado_boulder,accept,58
313,163,150,91.0,3.64,18,3,university_of_colorado_boulder,accept,58
321,168,153,110.0,3.52,30,2,university_of_colorado_boulder,accept,58
308,158,150,96.0,3.64,10,3,university_of_colorado_boulder,accept,58
317,164,153,110.0,3.65,24,3,university_of_colorado_boulder,accept,58
310,162,148,111.0,3.56,31,3,university_of_colorado_boulder,accept,58
310,162,148,111.0,3.56,31,3,university_of_colorado_boulder,accept,58
314,158,156,106.0,3.58,30,2,university_of_colorado_boulder,accept,58
313,164,149,106.0,3.65,30,0,university_of_colorado_boulder,accept,58
308,161,147,97.0,2.83,0,0,university_of_colorado_boulder,accept,58
322,164,158,108.0,3.42,10,0,university_of_colorado_boulder,accept,58
316,161,155,111.0,2.6,0,0,university_of_colorado_boulder,accept,58
318,163,155,109.0,3.68,30,3,university_of_colorado_boulder,accept,58
329,162,167,114.0,3.59,0,0,university_of_colorado_boulder,accept,58
310,164,146,94.0,3.58,30,3,university_of_colorado_boulder,accept,58
325,168,157,106.0,2.94,16,0,university_of_colorado_boulder,reject,58
325,168,157,106.0,2.94,16,0,university_of_colorado_boulder,reject,58
307,157,150,102.0,3.18,0,3,university_of_colorado_boulder,reject,58
310,168,142,75.0,3.12,10,3,university_of_colorado_boulder,reject,58
319,162,157,111.0,3.31,35,3,university_of_colorado_boulder,reject,58
316,161,155,107.0,3.6,12,3,university_of_colorado_boulder,reject,58
324,170,154,105.0,2.8,0,0,university_of_colorado_boulder,reject,58
314,160,154,107.0,2.99,24,0,university_of_colorado_boulder,reject,58
310,161,149,90.0,3.44,0,0,university_of_colorado_boulder,reject,58
319,167,152,116.0,3.38,16,0,university_of_colorado_boulder,reject,58
317,169,148,96.0,2.79,9,3,university_of_colorado_boulder,reject,58
310,161,149,97.0,2.65,2,0,university_of_colorado_boulder,reject,58
312,165,147,101.0,3.36,4,0,university_of_colorado_boulder,reject,58
319,163,156,115.0,3.2,1,2,university_of_colorado_boulder,reject,58
307,161,146,101.0,3.62,36,0,university_of_colorado_boulder,reject,58
312,166,146,103.0,3.15,27,0,university_of_colorado_boulder,reject,58
325,168,157,106.0,2.94,16,0,university_of_colorado_boulder,reject,58
325,168,157,106.0,2.94,16,0,university_of_colorado_boulder,reject,58
305,162,143,104.0,3.17,28,2,university_of_colorado_boulder,reject,58
310,168,142,75.0,3.12,10,3,university_of_colorado_boulder,reject,58
319,162,157,111.0,3.31,35,3,university_of_colorado_boulder,reject,58
320,161,159,75.0,3.32,8,0,university_of_colorado_boulder,reject,58
324,170,154,105.0,2.8,0,0,university_of_colorado_boulder,reject,58
314,160,154,107.0,2.99,24,0,university_of_colorado_boulder,reject,58
310,161,149,90.0,3.44,0,0,university_of_colorado_boulder,reject,58
304,161,143,87.0,3.02,40,0,university_of_colorado_boulder,reject,58
317,169,148,96.0,2.79,9,3,university_of_colorado_boulder,reject,58
310,161,149,97.0,2.65,2,0,university_of_colorado_boulder,reject,58
312,165,147,101.0,3.36,4,0,university_of_colorado_boulder,reject,58
314,164,150,103.0,3.56,17,3,university_of_colorado_boulder,reject,58
307,161,146,101.0,3.62,36,0,university_of_colorado_boulder,reject,58
312,166,146,103.0,3.15,27,0,university_of_colorado_boulder,reject,58
309,163,146,93.0,2.87,3,3,university_of_colorado_boulder,reject,58
306,159,147,99.0,3.0,0,0,university_of_colorado_boulder,reject,58
320,166,154,103.0,2.97,25,0,university_of_colorado_boulder,reject,58
327,165,162,115.0,3.2,30,0,university_of_colorado_boulder,reject,58
320,167,153,103.0,3.23,5,3,university_of_colorado_boulder,reject,58
312,158,154,90.0,3.38,0,3,university_of_colorado_boulder,reject,58
313,164,149,75.0,3.57,12,0,university_of_colorado_boulder,reject,58
304,161,143,94.0,3.55,46,0,university_of_colorado_boulder,reject,58
322,170,152,107.0,3.08,8,0,university_of_colorado_boulder,reject,58
310,156,154,105.0,3.38,5,3,university_of_colorado_boulder,reject,58
319,167,152,114.0,3.63,6,0,university_of_colorado_boulder,reject,58
315,166,149,96.0,3.45,32,0,university_of_colorado_boulder,reject,58
331,165,166,115.0,2.35,46,0,university_of_colorado_boulder,reject,58
317,165,152,107.0,3.72,0,2,university_of_colorado_boulder,reject,58
325,164,161,111.0,3.32,18,2,university_of_colorado_boulder,reject,58
321,170,151,75.0,2.99,27,0,university_of_colorado_boulder,reject,58
310,165,145,94.0,2.9,36,0,university_of_colorado_boulder,reject,58
315,164,151,93.0,2.43,14,0,university_of_colorado_boulder,reject,58
313,156,157,102.0,3.16,31,0,university_of_colorado_boulder,reject,58
312,165,147,91.0,3.13,21,0,university_of_colorado_boulder,reject,58
314,164,150,102.0,2.67,15,0,university_of_colorado_boulder,reject,58
315,160,155,105.0,3.24,30,0,university_of_colorado_boulder,reject,58
318,165,153,108.0,3.51,26,0,university_of_colorado_boulder,reject,58
314,159,155,100.0,3.53,33,0,university_of_colorado_boulder,reject,58
326,169,157,111.0,3.35,6,0,university_of_colorado_boulder,reject,58
320,165,155,103.0,3.59,4,0,university_of_colorado_boulder,reject,58
325,169,156,112.0,3.2,36,3,university_of_colorado_boulder,reject,58
322,170,152,101.0,3.53,3,0,university_of_colorado_boulder,reject,58
315,160,155,113.0,3.65,6,2,university_of_colorado_boulder,reject,58
320,163,157,110.0,3.54,24,0,university_of_colorado_boulder,reject,58
314,161,153,100.0,3.16,0,0,university_of_colorado_boulder,reject,58
319,167,152,75.0,2.5,13,0,university_of_colorado_boulder,reject,58
322,165,157,118.0,3.56,1,0,university_of_colorado_boulder,reject,58
322,165,157,118.0,3.56,1,0,university_of_colorado_boulder,reject,58
317,162,155,111.0,3.65,2,0,university_of_colorado_boulder,reject,58
310,158,152,104.0,3.6,0,0,university_of_colorado_boulder,reject,58
313,162,151,113.0,3.5,6,0,university_of_colorado_boulder,reject,58
312,160,152,88.0,3.44,36,3,university_of_colorado_boulder,reject,58
310,161,149,95.0,3.0,30,0,university_of_colorado_boulder,reject,58
321,161,160,118.0,3.12,1,2,university_of_colorado_boulder,reject,58
321,164,157,112.0,3.36,5,2,university_of_colorado_boulder,reject,58
309,159,150,97.0,2.75,31,0,university_of_colorado_boulder,reject,58
316,163,153,99.0,2.71,30,0,university_of_colorado_boulder,reject,58
314,161,153,108.0,3.38,17,3,university_of_colorado_boulder,reject,58
314,162,152,98.0,3.42,0,0,university_of_colorado_boulder,reject,58
325,168,157,113.0,2.62,39,3,university_of_colorado_boulder,reject,58
319,164,155,108.0,3.28,30,0,university_of_colorado_boulder,reject,58
315,163,152,102.0,3.0,0,0,university_of_colorado_boulder,reject,58
315,163,152,103.0,3.43,31,0,university_of_colorado_boulder,reject,58
324,167,157,105.0,2.88,2,0,university_of_colorado_boulder,reject,58
324,167,157,105.0,2.88,2,0,university_of_colorado_boulder,reject,58
319,162,157,112.0,1.9,60,0,university_of_colorado_boulder,reject,58
315,164,151,105.0,3.32,27,0,university_of_colorado_boulder,reject,58
314,162,152,106.0,3.36,6,0,university_of_colorado_boulder,reject,58
319,166,153,91.0,3.14,0,3,university_of_colorado_boulder,reject,58
316,164,152,97.0,2.6,2,0,university_of_colorado_boulder,reject,58
315,165,150,0,3.34,18,0,university_of_colorado_boulder,reject,58
307,160,147,75.0,3.48,11,0,university_of_colorado_boulder,reject,58
320,162,158,0,3.14,19,3,university_of_colorado_boulder,reject,58
323,156,167,107.0,3.02,36,0,university_of_colorado_boulder,reject,58
315,161,154,0,2.84,1,0,university_of_colorado_boulder,reject,58
316,149,167,104.0,3.36,8,0,university_of_colorado_boulder,reject,58
328,170,158,111.0,2.75,5,0,university_of_colorado_boulder,reject,58
309,159,150,102.0,2.65,0,0,university_of_colorado_boulder,reject,58
321,168,153,0,2.77,18,0,university_of_colorado_boulder,reject,58
322,167,155,107.0,2.86,27,3,university_of_colorado_boulder,reject,58
333,169,164,115.0,2.86,15,0,university_of_colorado_boulder,reject,58
333,169,164,115.0,2.86,15,0,university_of_colorado_boulder,reject,58
312,158,154,104.0,2.96,30,3,university_of_colorado_boulder,reject,58
320,165,155,103.0,2.35,31,0,university_of_colorado_boulder,reject,58
310,162,148,106.0,3.44,12,3,university_of_colorado_boulder,reject,58
319,169,150,103.0,2.88,27,0,university_of_colorado_boulder,reject,58
303,161,142,86.0,3.12,3,0,university_of_colorado_boulder,reject,58
324,169,155,0,2.0,18,0,university_of_colorado_boulder,reject,58
317,165,152,102.0,3.09,13,0,university_of_colorado_boulder,reject,58
308,161,147,65.0,3.23,29,0,university_of_colorado_boulder,reject,58
323,167,156,0,3.54,6,3,university_of_colorado_boulder,reject,58
322,165,157,111.0,2.15,20,0,university_of_colorado_boulder,reject,58
322,165,157,110.0,3.14,57,0,university_of_colorado_boulder,reject,58
320,162,158,112.0,3.02,28,0,university_of_colorado_boulder,reject,58
320,166,154,101.0,3.34,7,0,university_of_colorado_boulder,reject,58
310,160,150,97.0,2.73,60,2,university_of_colorado_boulder,reject,58
318,166,152,102.0,2.77,8,3,university_of_colorado_boulder,reject,58
303,160,143,96.0,3.2,8,0,university_of_colorado_boulder,reject,58
320,168,152,103.0,3.71,38,0,university_of_colorado_boulder,reject,58
313,166,147,99.0,3.6,0,3,university_of_colorado_boulder,reject,58
305,163,142,89.0,3.48,28,0,university_of_colorado_boulder,reject,58
326,165,161,116.0,3.31,2,0,university_of_colorado_boulder,reject,58
314,161,153,95.0,3.16,44,0,university_of_colorado_boulder,reject,58
318,160,158,109.0,2.87,41,0,university_of_colorado_boulder,reject,58
317,163,154,111.0,2.82,24,3,university_of_colorado_boulder,reject,58
322,167,155,114.0,3.51,20,3,university_of_colorado_boulder,reject,58
301,157,144,98.0,3.09,44,0,university_of_colorado_boulder,reject,58
312,159,153,0,3.08,0,0,university_of_colorado_boulder,reject,58
313,161,152,110.0,3.05,4,0,university_of_colorado_boulder,reject,58
320,167,153,0,3.04,1,2,university_of_colorado_boulder,reject,58
319,162,157,0,3.2,20,3,university_of_colorado_boulder,reject,58
309,162,147,93.0,3.54,18,0,university_of_colorado_boulder,reject,58
313,163,150,107.0,2.96,13,3,university_of_colorado_boulder,reject,58
318,168,150,102.0,3.06,29,0,university_of_colorado_boulder,reject,58
305,155,150,101.0,3.36,24,3,university_of_colorado_boulder,reject,58
312,161,151,104.0,2.5,2,1,university_of_colorado_boulder,reject,58
323,169,154,0,3.64,0,0,university_of_colorado_boulder,reject,58
310,163,147,99.0,2.72,13,0,university_of_colorado_boulder,reject,58
328,168,160,0,2.72,19,3,university_of_colorado_boulder,reject,58
307,161,146,101,3.17,2,3,university_of_colorado_boulder,reject,58
307,164,143,93.0,3.21,22,3,university_of_colorado_boulder,reject,58
323,168,155,110.0,3.52,5,2,university_of_colorado_boulder,reject,58
324,167,157,110.0,2.99,0,0,university_of_colorado_boulder,reject,58
310,167,143,93.0,2.96,13,0,university_of_colorado_boulder,reject,58
314,165,149,96.0,2.5,50,0,university_of_colorado_boulder,reject,58
325,170,155,105.0,2.66,48,0,university_of_colorado_boulder,reject,58
314,163,151,91.0,3.22,28,0,university_of_colorado_boulder,reject,58
319,166,153,104.0,2.84,22,0,university_of_colorado_boulder,reject,58
325,163,162,116.0,3.34,34,0,university_of_colorado_boulder,reject,58
325,163,162,116.0,3.34,34,0,university_of_colorado_boulder,reject,58
321,164,157,106.0,1.28,23,0,university_of_colorado_boulder,reject,58
315,166,149,98.0,3.26,26,0,university_of_colorado_boulder,reject,58
323,170,153,0,3.2,12,0,university_of_colorado_boulder,reject,58
314,166,148,0,3.61,3,3,university_of_colorado_boulder,reject,58
310,159,151,98.0,3.55,16,0,university_of_colorado_boulder,reject,58
319,159,160,0,3.4,23,0,university_of_colorado_boulder,reject,58
319,168,151,105.0,3.53,18,3,university_of_colorado_boulder,reject,58
319,160,159,115.0,2.9,0,0,university_of_colorado_boulder,reject,58
312,164,148,90.0,3.3,41,0,university_of_colorado_boulder,reject,58
328,169,159,113.0,2.83,16,2,university_of_colorado_boulder,reject,58
313,156,157,110.0,2.89,4,0,university_of_colorado_boulder,reject,58
319,154,165,105.0,2.1,0,0,university_of_colorado_boulder,reject,58
322,165,157,94.0,3.28,20,0,university_of_colorado_boulder,reject,58
318,161,157,97.0,2.5,0,0,university_of_colorado_boulder,reject,58
318,161,157,97.0,2.5,0,0,university_of_colorado_boulder,reject,58
314,160,154,106.0,2.82,12,0,university_of_colorado_boulder,reject,58
299,155,144,96.0,2.71,4,3,university_of_colorado_boulder,reject,58
314,162,152,106.0,3.78,12,0,university_of_colorado_boulder,reject,58
310,162,148,101.0,2.9,14,0,university_of_colorado_boulder,reject,58
310,163,147,100.0,3.15,5,0,university_of_colorado_boulder,reject,58
321,159,162,115.0,2.35,20,3,university_of_colorado_boulder,reject,58
322,166,156,108.0,3.34,34,0,university_of_colorado_boulder,reject,58
317,165,152,107.0,3.1,0,0,university_of_colorado_boulder,reject,58
310,161,149,97.0,3.42,2,3,university_of_colorado_boulder,reject,58
303,158,145,87.0,2.46,0,3,university_of_colorado_boulder,reject,58
318,166,152,104.0,2.72,2,2,university_of_colorado_boulder,reject,58
314,163,151,97.0,3.2,0,3,university_of_colorado_boulder,reject,58
320,167,153,112.0,3.2,0,0,university_of_colorado_boulder,reject,58
314,165,149,110.0,3.24,0,0,university_of_colorado_boulder,reject,58
307,158,149,95.0,2.82,18,0,university_of_colorado_boulder,reject,58
313,161,152,109.0,3.16,31,0,university_of_colorado_boulder,reject,58
313,161,152,109.0,3.16,31,0,university_of_colorado_boulder,reject,58
324,170,154,112.0,2.5,17,1,university_of_colorado_boulder,reject,58
311,161,150,65.0,3.37,7,0,university_of_colorado_boulder,reject,58
308,159,149,92.0,3.58,8,0,university_of_colorado_boulder,reject,58
320,165,155,109.0,3.05,8,0,university_of_colorado_boulder,reject,58
317,165,152,103.0,2.9,24,3,university_of_colorado_boulder,reject,58
308,161,147,103.0,2.06,37,0,university_of_colorado_boulder,reject,58
313,163,150,99.0,2.82,25,0,university_of_colorado_boulder,reject,58
312,162,150,99.0,3.4,34,3,university_of_colorado_boulder,reject,58
325,170,155,100.0,3.03,18,0,university_of_colorado_boulder,reject,58
323,168,155,110.0,3.24,17,0,university_of_colorado_boulder,reject,58
311,159,152,103.0,3.08,1,0,university_of_colorado_boulder,reject,58
310,158,152,109.0,2.49,29,0,university_of_colorado_boulder,reject,58
312,164,148,95.0,2.65,51,0,university_of_colorado_boulder,reject,58
312,163,149,101.0,3.01,22,0,university_of_colorado_boulder,reject,58
317,165,152,104.0,1.95,26,0,university_of_colorado_boulder,reject,58
328,167,161,117.0,3.28,16,0,university_of_california_irvine,accept,23
328,167,161,117.0,3.28,16,0,university_of_california_irvine,accept,23
324,169,155,112.0,3.77,19,0,university_of_california_irvine,accept,23
320,170,150,104.0,2.96,28,0,university_of_california_irvine,accept,23
321,166,155,104.0,3.37,8,0,university_of_california_irvine,accept,23
322,167,155,105.0,3.4,36,0,university_of_california_irvine,accept,23
319,166,153,111.0,3.69,14,0,university_of_california_irvine,accept,23
324,168,156,111.0,3.3,26,2,university_of_california_irvine,accept,23
317,165,152,100.0,3.27,0,0,university_of_california_irvine,accept,23
333,170,163,112.0,3.34,52,0,university_of_california_irvine,accept,23
323,168,155,107.0,3.31,2,0,university_of_california_irvine,accept,23
327,170,157,112.0,3.16,26,0,university_of_california_irvine,accept,23
323,170,153,103.0,3.6,15,0,university_of_california_irvine,accept,23
328,166,162,118.0,3.49,6,3,university_of_california_irvine,accept,23
326,169,157,111.0,3.35,6,0,university_of_california_irvine,accept,23
328,167,161,117.0,3.28,16,0,university_of_california_irvine,accept,23
328,167,161,117.0,3.28,16,0,university_of_california_irvine,accept,23
327,167,160,114.0,3.35,48,2,university_of_california_irvine,accept,23
320,170,150,104.0,2.96,28,0,university_of_california_irvine,accept,23
321,166,155,104.0,3.37,8,0,university_of_california_irvine,accept,23
326,166,160,112.0,2.83,48,0,university_of_california_irvine,accept,23
322,167,155,105.0,3.4,36,0,university_of_california_irvine,accept,23
319,166,153,111.0,3.69,14,0,university_of_california_irvine,accept,23
324,168,156,111.0,3.3,26,2,university_of_california_irvine,accept,23
328,169,159,109.0,3.64,0,0,university_of_california_irvine,accept,23
333,170,163,112.0,3.34,52,0,university_of_california_irvine,accept,23
323,168,155,107.0,3.31,2,0,university_of_california_irvine,accept,23
327,170,157,112.0,3.16,26,0,university_of_california_irvine,accept,23
324,169,155,111.0,3.2,28,0,university_of_california_irvine,accept,23
328,166,162,118.0,3.49,6,3,university_of_california_irvine,accept,23
326,169,157,111.0,3.35,6,0,university_of_california_irvine,accept,23
330,170,160,110.0,3.32,31,0,university_of_california_irvine,accept,23
321,166,155,114.0,3.6,5,0,university_of_california_irvine,accept,23
321,166,155,107.0,3.54,9,3,university_of_california_irvine,accept,23
327,169,158,108.0,3.28,29,0,university_of_california_irvine,accept,23
328,168,160,110.0,3.6,14,1,university_of_california_irvine,accept,23
330,166,164,117.0,3.55,40,0,university_of_california_irvine,accept,23
322,167,155,106.0,3.07,21,0,university_of_california_irvine,accept,23
320,168,152,101.0,3.44,17,0,university_of_california_irvine,accept,23
323,168,155,108.0,3.6,33,0,university_of_california_irvine,accept,23
323,167,156,105.0,3.06,23,0,university_of_california_irvine,accept,23
315,161,154,0,2.84,1,0,university_of_california_irvine,accept,23
317,162,155,0,3.2,34,0,university_of_california_irvine,accept,23
319,167,152,114.0,3.47,2,0,university_of_california_irvine,accept,23
329,170,159,116.0,3.64,10,3,university_of_california_irvine,accept,23
334,169,165,114.0,3.71,38,0,university_of_california_irvine,accept,23
322,170,152,107.0,3.56,39,0,university_of_california_irvine,accept,23
315,159,156,106.0,3.79,12,2,university_of_california_irvine,accept,23
325,170,155,114.0,3.24,0,0,university_of_california_irvine,accept,23
322,166,156,0,3.71,0,0,university_of_california_irvine,accept,23
317,164,153,107.0,3.47,26,0,university_of_california_irvine,accept,23
313,164,149,99.0,3.38,29,0,university_of_california_irvine,accept,23
336,170,166,117.0,3.43,2,0,university_of_california_irvine,accept,23
326,170,156,111.0,3.47,20,0,university_of_california_irvine,accept,23
323,165,158,115.0,3.56,18,3,university_of_california_irvine,accept,23
323,165,158,115.0,3.56,18,3,university_of_california_irvine,accept,23
319,168,151,104.0,3.28,0,3,university_of_california_irvine,accept,23
322,167,155,117.0,3.53,2,3,university_of_california_irvine,accept,23
320,166,154,105.0,3.58,4,3,university_of_california_irvine,accept,23
323,170,153,0,3.2,12,0,university_of_california_irvine,accept,23
319,168,151,106.0,3.3,34,0,university_of_california_irvine,accept,23
322,167,155,113.0,3.56,0,0,university_of_california_irvine,accept,23
318,168,150,0,3.0,24,3,university_of_california_irvine,accept,23
328,169,159,116.0,3.24,29,0,university_of_california_irvine,accept,23
322,163,159,113.0,3.52,4,0,university_of_california_irvine,accept,23
320,170,150,105.0,3.5,26,0,university_of_california_irvine,accept,23
330,170,160,117.0,3.28,0,0,university_of_california_irvine,accept,23
324,164,160,100.0,2.5,0,0,university_of_california_irvine,accept,23
316,169,147,94.0,2.88,0,0,university_of_california_irvine,accept,23
308,159,149,107.0,3.56,40,2,university_of_california_irvine,accept,23
307,158,149,99.0,3.6,36,1,university_of_california_irvine,accept,23
307,158,149,99.0,3.6,36,1,university_of_california_irvine,accept,23
319,167,152,93.0,3.44,3,0,university_of_california_irvine,accept,23
323,164,159,113.0,3.4,3,0,university_of_california_irvine,accept,23
318,166,152,96.0,3.35,12,2,university_of_california_irvine,accept,23
329,170,159,111.0,3.36,1,0,university_of_california_irvine,accept,23
312,165,147,75.0,3.47,14,0,university_of_california_irvine,accept,23
326,165,161,110.0,2.84,12,0,university_of_california_irvine,accept,23
324,170,154,110.0,3.43,2,0,university_of_california_irvine,accept,23
321,170,151,105.0,3.47,7,3,university_of_california_irvine,accept,23
325,168,157,107.0,3.6,2,0,university_of_california_irvine,accept,23
313,162,151,103.0,3.01,4,0,university_of_california_irvine,accept,23
312,162,150,96.0,3.48,32,3,university_of_california_irvine,accept,23
319,165,154,108.0,3.22,36,0,university_of_california_irvine,accept,23
315,167,148,104.0,3.61,16,3,university_of_california_irvine,accept,23
320,164,156,115.0,1.4,2,3,university_of_california_irvine,accept,23
318,169,149,103.0,3.48,7,0,university_of_california_irvine,accept,23
315,167,148,102.0,3.64,6,0,university_of_california_irvine,accept,23
315,167,148,102.0,3.64,6,0,university_of_california_irvine,accept,23
326,170,156,110.0,3.28,4,0,university_of_california_irvine,accept,23
326,170,156,101.0,3.47,8,0,university_of_california_irvine,accept,23
320,167,153,103.0,3.38,40,0,university_of_california_irvine,accept,23
329,170,159,97.0,3.76,2,0,university_of_california_irvine,accept,23
322,166,156,113.0,3.0,30,3,university_of_california_irvine,accept,23
331,170,161,117.0,3.94,0,3,university_of_california_irvine,accept,23
333,170,163,117.0,3.74,2,0,university_of_california_irvine,accept,23
313,164,149,100.0,3.76,15,3,university_of_california_irvine,accept,23
323,166,157,117.0,3.68,10,3,university_of_california_irvine,accept,23
323,165,158,116.0,3.54,22,0,university_of_california_irvine,accept,23
324,163,161,112.0,3.72,18,0,university_of_california_irvine,accept,23
325,168,157,101.0,3.24,7,3,university_of_california_irvine,accept,23
321,168,153,102.0,3.8,10,0,university_of_california_irvine,accept,23
318,163,155,95.0,3.2,10,3,university_of_california_irvine,accept,23
323,166,157,114.0,3.78,0,0,university_of_california_irvine,accept,23
311,161,150,106.0,3.88,20,0,university_of_california_irvine,accept,23
331,170,161,110.0,2.86,30,0,university_of_california_irvine,accept,23
315,163,152,104.0,3.48,20,0,university_of_california_irvine,accept,23
329,165,164,118.0,3.34,10,0,university_of_california_irvine,accept,23
329,170,159,108.0,3.1,30,3,university_of_california_irvine,accept,23
328,168,160,106.0,3.3,20,0,university_of_california_irvine,accept,23
322,170,152,103.0,3.0,0,0,university_of_california_irvine,accept,23
311,168,143,109.0,3.2,10,3,university_of_california_irvine,accept,23
322,169,153,103.0,3.37,0,0,university_of_california_irvine,accept,23
311,168,143,109.0,3.58,10,3,university_of_california_irvine,accept,23
316,163,153,103.0,2.65,21,0,university_of_california_irvine,reject,23
320,163,157,113.0,3.77,0,2,university_of_california_irvine,reject,23
327,168,159,109.0,3.46,14,0,university_of_california_irvine,reject,23
317,159,158,114.0,3.52,4,1,university_of_california_irvine,reject,23
314,168,146,101,2.65,12,0,university_of_california_irvine,reject,23
318,167,151,108.0,2.94,24,0,university_of_california_irvine,reject,23
321,167,154,107.0,2.25,0,0,university_of_california_irvine,reject,23
325,170,155,107.0,2.85,9,0,university_of_california_irvine,reject,23
325,170,155,105.0,2.98,40,0,university_of_california_irvine,reject,23
328,169,159,106.0,2.84,30,0,university_of_california_irvine,reject,23
325,168,157,116.0,3.46,2,0,university_of_california_irvine,reject,23
318,163,155,110.0,3.37,48,0,university_of_california_irvine,reject,23
323,167,156,105.0,2.85,52,0,university_of_california_irvine,reject,23
323,167,156,106.0,2.85,13,0,university_of_california_irvine,reject,23
315,163,152,107.0,3.65,26,0,university_of_california_irvine,reject,23
320,166,154,103.0,3.0,12,3,university_of_california_irvine,reject,23
317,163,154,112.0,3.71,9,2,university_of_california_irvine,reject,23
326,168,158,110.0,2.92,60,0,university_of_california_irvine,reject,23
326,165,161,110.0,2.69,30,0,university_of_california_irvine,reject,23
305,158,147,101,2.25,1,0,university_of_california_irvine,reject,23
305,158,147,101,2.25,1,0,university_of_california_irvine,reject,23
318,166,152,110.0,3.14,6,0,university_of_california_irvine,reject,23
318,169,149,109.0,3.48,0,0,university_of_california_irvine,reject,23
314,164,150,104.0,2.65,28,0,university_of_california_irvine,reject,23
315,165,150,97.0,3.53,24,0,university_of_california_irvine,reject,23
319,168,151,95.0,3.67,20,0,university_of_california_irvine,reject,23
318,163,155,108.0,2.35,6,2,university_of_california_irvine,reject,23
314,163,151,96.0,3.34,27,0,university_of_california_irvine,reject,23
327,168,159,115.0,3.02,18,0,university_of_california_irvine,reject,23
322,168,154,101.0,3.11,27,0,university_of_california_irvine,reject,23
327,168,159,115.0,3.02,18,0,university_of_california_irvine,reject,23
322,168,154,101.0,3.11,27,0,university_of_california_irvine,reject,23
322,167,155,108.0,3.24,32,3,university_of_california_irvine,reject,23
322,170,152,101.0,3.53,3,0,university_of_california_irvine,reject,23
315,165,150,98.0,3.76,6,3,university_of_california_irvine,reject,23
328,167,161,105.0,3.3,36,0,university_of_california_irvine,reject,23
317,165,152,96.0,2.98,4,0,university_of_california_irvine,reject,23
318,170,148,101.0,3.25,7,0,university_of_california_irvine,reject,23
324,155,169,114,3.24,0,0,university_of_california_irvine,reject,23
317,166,151,96.0,3.64,6,0,university_of_california_irvine,reject,23
316,164,152,102.0,3.41,0,0,university_of_california_irvine,reject,23
313,165,148,102.0,2.86,41,0,university_of_california_irvine,reject,23
311,164,147,99.0,3.46,17,0,university_of_california_irvine,reject,23
311,164,147,99.0,3.46,17,0,university_of_california_irvine,reject,23
317,166,151,106.0,3.12,32,0,university_of_california_irvine,reject,23
316,162,154,108.0,3.23,24,0,university_of_california_irvine,reject,23
307,158,149,89.0,3.14,0,0,university_of_california_irvine,reject,23
320,161,159,114,3.19,0,0,university_of_california_irvine,reject,23
315,160,155,104.0,3.23,27,0,university_of_california_irvine,reject,23
319,164,155,103.0,2.97,19,0,university_of_california_irvine,reject,23
313,161,152,98.0,3.03,2,0,university_of_california_irvine,reject,23
314,164,150,102.0,3.77,15,3,university_of_california_irvine,reject,23
315,168,147,75.0,3.58,6,3,university_of_california_irvine,reject,23
315,164,151,111.0,3.52,18,1,university_of_california_irvine,reject,23
312,167,145,93.0,3.32,12,0,university_of_california_irvine,reject,23
312,159,153,103.0,3.16,4,0,university_of_california_irvine,reject,23
315,165,150,96.0,3.38,17,2,university_of_california_irvine,reject,23
324,168,156,114.0,3.02,11,2,university_of_california_irvine,reject,23
326,170,156,110.0,3.06,5,3,university_of_california_irvine,reject,23
317,166,151,104.0,3.56,16,0,university_of_california_irvine,reject,23
318,165,153,108.0,3.51,26,0,university_of_california_irvine,reject,23
315,165,150,94.0,2.81,30,3,university_of_california_irvine,reject,23
311,163,148,89.0,3.48,15,0,university_of_california_irvine,reject,23
313,165,148,94.0,3.53,41,0,university_of_california_irvine,reject,23
313,165,148,94.0,3.53,41,0,university_of_california_irvine,reject,23
313,160,153,98.0,3.49,7,3,university_of_california_irvine,reject,23
319,168,151,109.0,3.34,12,0,university_of_california_irvine,reject,23
313,160,153,104.0,3.11,42,0,university_of_california_irvine,reject,23
319,167,152,96.0,3.61,2,3,university_of_california_irvine,reject,23
321,168,153,103.0,3.52,6,3,university_of_california_irvine,reject,23
321,170,151,100.0,3.06,2,0,university_of_california_irvine,reject,23
316,164,152,108.0,3.23,30,3,university_of_california_irvine,reject,23
322,169,153,110.0,2.5,12,0,university_of_california_irvine,reject,23
317,159,158,106.0,3.54,5,0,university_of_california_irvine,reject,23
307,155,152,90.0,2.46,28,3,university_of_california_irvine,reject,23
312,165,147,75.0,3.82,24,0,university_of_california_irvine,reject,23
319,162,157,106.0,3.34,36,0,university_of_california_irvine,reject,23
314,159,155,104.0,3.73,18,0,university_of_california_irvine,reject,23
313,162,151,95.0,3.2,0,0,university_of_california_irvine,reject,23
315,168,147,100.0,2.8,24,0,university_of_california_irvine,reject,23
312,160,152,104.0,3.19,0,0,university_of_california_irvine,reject,23
317,169,148,100.0,3.36,31,0,university_of_california_irvine,reject,23
325,165,160,110.0,3.06,24,3,university_of_california_irvine,reject,23
315,165,150,103.0,3.73,30,1,university_of_california_irvine,reject,23
324,165,159,113.0,3.04,24,0,university_of_california_irvine,reject,23
324,165,159,113.0,3.04,24,0,university_of_california_irvine,reject,23
308,163,145,105.0,3.55,48,0,university_of_california_irvine,reject,23
311,163,148,102.0,3.41,28,0,university_of_california_irvine,reject,23
319,169,150,106.0,3.56,29,0,university_of_california_irvine,reject,23
315,166,149,97.0,3.34,31,0,university_of_california_irvine,reject,23
323,167,156,110.0,2.89,42,0,university_of_california_irvine,reject,23
311,159,152,101.0,3.27,16,0,university_of_california_irvine,reject,23
324,168,156,107.0,3.38,3,0,university_of_california_irvine,reject,23
325,168,157,105.0,2.95,28,0,university_of_california_irvine,reject,23
318,160,158,112.0,3.2,0,0,university_of_california_irvine,reject,23
314,165,149,110.0,3.68,5,0,university_of_california_irvine,reject,23
314,170,144,90.0,3.0,18,2,university_of_california_irvine,reject,23
327,165,162,114.0,3.28,38,0,university_of_california_irvine,reject,23
323,167,156,110.0,3.4,41,0,university_of_california_irvine,reject,23
315,163,152,102.0,3.6,31,0,university_of_california_irvine,reject,23
314,164,150,103.0,3.64,1,3,university_of_california_irvine,reject,23
310,161,149,95.0,3.0,30,0,university_of_california_irvine,reject,23
314,160,154,112.0,2.92,18,0,university_of_california_irvine,reject,23
325,170,155,105.0,2.82,17,0,university_of_california_irvine,reject,23
310,161,149,106.0,3.2,5,0,university_of_california_irvine,reject,23
314,163,151,98.0,3.12,18,0,university_of_california_irvine,reject,23
314,163,151,98.0,3.12,18,0,university_of_california_irvine,reject,23
317,166,151,100.0,3.49,32,0,university_of_california_irvine,reject,23
315,163,152,110.0,3.48,2,0,university_of_california_irvine,reject,23
317,165,152,105.0,3.5,20,0,university_of_california_irvine,reject,23
326,169,157,115.0,3.58,27,0,university_of_california_irvine,reject,23
315,162,153,100.0,2.8,17,0,university_of_california_irvine,reject,23
318,166,152,104.0,3.4,18,0,university_of_california_irvine,reject,23
311,157,154,96.0,3.6,48,0,university_of_california_irvine,reject,23
319,163,156,115.0,3.2,1,2,university_of_california_irvine,reject,23
314,161,153,108.0,3.38,17,3,university_of_california_irvine,reject,23
315,165,150,107.0,3.45,26,0,university_of_california_irvine,reject,23
314,164,150,110.0,3.55,25,3,university_of_california_irvine,reject,23
320,166,154,114,3.56,1,0,university_of_california_irvine,reject,23
309,158,151,104.0,3.29,38,0,university_of_california_irvine,reject,23
310,161,149,102.0,2.79,31,3,university_of_california_irvine,reject,23
318,162,156,113.0,3.03,16,0,university_of_california_irvine,reject,23
314,166,148,89.0,2.67,13,2,university_of_california_irvine,reject,23
318,164,154,100.0,2.76,28,0,university_of_california_irvine,reject,23
325,165,160,108.0,3.16,2,0,university_of_california_irvine,reject,23
324,170,154,87.0,3.42,4,0,university_of_california_irvine,reject,23
315,164,151,103.0,3.81,32,0,university_of_california_irvine,reject,23
315,164,151,103.0,3.81,32,0,university_of_california_irvine,reject,23
319,168,151,106.0,2.05,38,0,university_of_california_irvine,reject,23
324,164,160,112.0,3.44,39,0,university_of_california_irvine,reject,23
315,162,153,100.0,3.36,18,0,university_of_california_irvine,reject,23
327,166,161,108.0,3.18,10,3,university_of_california_irvine,reject,23
328,170,158,114.0,2.99,17,0,university_of_california_irvine,reject,23
314,166,148,106.0,3.2,11,3,university_of_california_irvine,reject,23
322,168,154,104.0,3.36,50,0,university_of_california_irvine,reject,23
326,167,159,75.0,3.2,20,2,university_of_california_irvine,reject,23
320,169,151,104.0,3.52,25,0,university_of_california_irvine,reject,23
329,168,161,113.0,3.06,40,0,university_of_california_irvine,reject,23
324,169,155,116.0,3.42,26,3,university_of_california_irvine,reject,23
316,164,152,108.0,3.06,30,0,university_of_california_irvine,reject,23
312,166,146,99.0,3.45,36,0,university_of_california_irvine,reject,23
315,166,149,98.0,3.36,1,3,university_of_california_irvine,reject,23
321,167,154,112.0,3.44,37,0,university_of_california_irvine,reject,23
326,165,161,118.0,2.35,0,0,university_of_california_irvine,reject,23
323,166,157,115.0,3.04,21,0,university_of_california_irvine,reject,23
329,170,159,109.0,3.04,20,0,university_of_california_irvine,reject,23
311,160,151,107.0,3.78,10,0,university_of_california_irvine,reject,23
325,170,155,111.0,3.24,24,0,university_of_california_irvine,reject,23
325,170,155,111.0,3.24,24,0,university_of_california_irvine,reject,23
306,164,142,107.0,3.5,4,3,university_of_california_irvine,reject,23
328,167,161,115.0,3.26,13,0,university_of_california_irvine,reject,23
331,170,161,112.0,3.2,28,0,university_of_california_irvine,reject,23
306,154,152,109.0,3.41,0,0,university_of_california_irvine,reject,23
332,170,162,117.0,3.62,1,3,university_of_california_irvine,reject,23
313,162,151,102.0,3.12,1,0,university_of_california_irvine,reject,23
322,168,154,103.0,3.24,17,0,university_of_california_irvine,reject,23
311,163,148,101.0,3.0,39,0,university_of_california_irvine,reject,23
304,157,147,81.0,2.4,60,3,university_of_california_irvine,reject,23
320,163,157,108.0,3.56,3,0,university_of_california_irvine,reject,23
317,164,153,101,2.7,86,0,university_of_california_irvine,reject,23
312,163,149,95.0,3.28,24,3,university_of_california_irvine,reject,23
318,161,157,116.0,2.88,18,0,university_of_california_irvine,reject,23
334,170,164,117.0,3.28,0,3,university_of_california_irvine,reject,23
324,165,159,108.0,3.42,0,0,university_of_california_irvine,reject,23
329,169,160,116.0,2.99,31,2,university_of_california_irvine,reject,23
312,162,150,113.0,3.74,4,3,university_of_california_irvine,reject,23
316,163,153,104.0,3.24,48,0,university_of_california_irvine,reject,23
314,167,147,110.0,2.64,28,3,university_of_california_irvine,reject,23
322,165,157,110.0,2.4,30,0,university_of_california_irvine,reject,23
322,165,157,110.0,2.4,30,0,university_of_california_irvine,reject,23
322,168,154,111.0,2.96,16,3,university_of_california_irvine,reject,23
321,166,155,0,3.43,36,0,university_of_california_irvine,reject,23
316,163,153,0,3.73,1,0,university_of_california_irvine,reject,23
321,165,156,110.0,3.1,7,0,university_of_california_irvine,reject,23
319,170,149,95.0,3.63,49,0,university_of_california_irvine,reject,23
318,164,154,0,3.26,16,0,university_of_california_irvine,reject,23
329,167,162,115.0,3.56,0,3,university_of_california_irvine,reject,23
322,164,158,116.0,3.66,11,0,university_of_california_irvine,reject,23
330,169,161,113.0,3.6,0,0,university_of_california_irvine,reject,23
325,170,155,114.0,3.09,25,3,university_of_california_irvine,reject,23
319,170,149,110.0,3.59,6,0,university_of_california_irvine,reject,23
328,163,165,0,2.25,0,0,university_of_california_irvine,reject,23
317,167,150,75.0,2.06,21,0,university_of_california_irvine,reject,23
314,163,151,101.0,3.61,35,3,university_of_california_irvine,reject,23
326,169,157,0,3.01,32,0,university_of_california_irvine,reject,23
324,166,158,112.0,2.18,20,0,university_of_california_irvine,reject,23
322,161,161,109.0,2.9,7,1,university_of_california_irvine,reject,23
322,161,161,109.0,2.9,7,1,university_of_california_irvine,reject,23
324,167,157,107.0,3.71,1,0,university_of_california_irvine,reject,23
334,169,165,0,3.11,6,0,university_of_california_irvine,reject,23
315,163,152,113.0,3.25,6,0,university_of_california_irvine,reject,23
318,159,159,113.0,3.08,10,0,university_of_california_irvine,reject,23
315,161,154,112.0,2.36,12,3,university_of_california_irvine,reject,23
330,168,162,0,3.12,18,0,university_of_california_irvine,reject,23
316,169,147,107.0,2.84,40,0,university_of_california_irvine,reject,23
321,162,159,115.0,2.74,33,0,university_of_california_irvine,reject,23
320,162,158,112.0,3.02,28,0,university_of_california_irvine,reject,23
314,167,147,0,3.37,29,0,university_of_california_irvine,reject,23
311,163,148,100.0,3.4,20,0,university_of_california_irvine,reject,23
323,165,158,118.0,2.23,22,0,university_of_california_irvine,reject,23
323,169,154,0,3.64,0,0,university_of_california_irvine,reject,23
327,169,158,107.0,2.7,9,0,university_of_california_irvine,reject,23
314,164,150,92.0,2.6,18,0,university_of_california_irvine,reject,23
314,164,150,0,3.24,20,0,university_of_california_irvine,reject,23
329,170,159,110.0,3.48,22,3,university_of_california_irvine,reject,23
326,168,158,0,3.22,1,3,university_of_california_irvine,reject,23
326,168,158,0,3.22,1,3,university_of_california_irvine,reject,23
313,161,152,108.0,3.37,16,2,university_of_california_irvine,reject,23
331,170,161,111.0,3.28,2,3,university_of_california_irvine,reject,23
309,162,147,98.0,1.47,12,3,university_of_california_irvine,reject,23
317,165,152,102.0,3.09,13,0,university_of_california_irvine,reject,23
303,161,142,99.0,3.53,0,3,university_of_california_irvine,reject,23
316,170,146,98.0,2.8,30,0,university_of_california_irvine,reject,23
317,165,152,107.0,3.69,12,0,university_of_california_irvine,reject,23
328,168,160,0,2.72,19,3,university_of_california_irvine,reject,23
324,168,156,112.0,3.26,14,0,university_of_california_irvine,reject,23
319,165,154,0,3.54,8,0,university_of_california_irvine,reject,23
323,170,153,110.0,3.64,1,0,university_of_california_irvine,reject,23
328,169,159,108.0,3.42,3,0,university_of_california_irvine,reject,23
331,170,161,0,3.62,21,3,university_of_california_irvine,reject,23
325,166,159,0,3.22,20,0,university_of_california_irvine,reject,23
320,167,153,0,3.04,1,2,university_of_california_irvine,reject,23
325,168,157,108.0,3.13,21,3,university_of_california_irvine,reject,23
316,161,155,112.0,3.01,11,3,university_of_california_irvine,reject,23
330,169,161,0,3.55,8,0,university_of_california_irvine,reject,23
324,163,161,0,3.08,34,0,university_of_california_irvine,reject,23
322,154,168,0,3.52,0,0,university_of_california_irvine,reject,23
322,154,168,0,3.52,0,0,university_of_california_irvine,reject,23
311,165,146,104.0,3.32,47,0,university_of_california_irvine,reject,23
316,164,152,0,3.6,22,3,university_of_california_irvine,reject,23
333,170,163,111.0,2.63,10,3,university_of_california_irvine,reject,23
319,168,151,118.0,2.65,27,3,university_of_california_irvine,reject,23
323,167,156,114.0,3.34,12,0,university_of_california_irvine,reject,23
309,164,145,97.0,3.22,24,0,university_of_california_irvine,reject,23
317,162,155,101.0,3.49,24,0,university_of_california_irvine,reject,23
317,166,151,97.0,3.66,18,0,university_of_california_irvine,reject,23
316,164,152,97.0,2.6,2,0,university_of_california_irvine,reject,23
322,168,154,110.0,3.6,11,0,university_of_california_irvine,reject,23
321,168,153,101.0,2.8,64,0,university_of_california_irvine,reject,23
313,163,150,116.0,2.99,2,0,university_of_california_irvine,reject,23
317,165,152,0,3.34,24,3,university_of_california_irvine,reject,23
330,170,160,105.0,3.84,6,0,university_of_california_irvine,reject,23
260,130,130,0,2.8,0,0,university_of_california_irvine,reject,23
309,160,149,96.0,3.36,7,0,university_of_california_irvine,reject,23
312,160,152,0,2.92,14,0,university_of_california_irvine,reject,23
316,166,150,96.0,2.52,34,0,university_of_california_irvine,reject,23
318,167,151,112.0,2.9,2,3,university_of_california_irvine,reject,23
318,167,151,112.0,2.9,2,3,university_of_california_irvine,reject,23
325,170,155,106.0,3.12,21,0,university_of_california_irvine,reject,23
324,167,157,111.0,2.85,40,1,university_of_california_irvine,reject,23
322,168,154,104.0,3.76,40,0,university_of_california_irvine,reject,23
322,167,155,107.0,3.28,15,0,university_of_california_irvine,reject,23
332,162,170,114.0,3.28,34,0,university_of_california_irvine,reject,23
314,166,148,101.0,2.83,20,0,university_of_california_irvine,reject,23
320,169,151,106.0,3.38,2,3,university_of_california_irvine,reject,23
310,162,148,106.0,3.44,12,3,university_of_california_irvine,reject,23
322,166,156,108.0,3.28,45,0,university_of_california_irvine,reject,23
325,170,155,106.0,2.59,31,0,university_of_california_irvine,reject,23
325,167,158,114.0,3.46,33,0,university_of_california_irvine,reject,23
321,165,156,110.0,3.67,6,0,university_of_california_irvine,reject,23
317,169,148,107.0,3.48,40,0,university_of_california_irvine,reject,23
331,168,163,115.0,2.4,24,0,university_of_california_irvine,reject,23
319,167,152,103.0,3.22,15,0,university_of_california_irvine,reject,23
314,166,148,101.0,2.83,24,0,university_of_california_irvine,reject,23
326,170,156,101.0,3.48,19,3,university_of_california_irvine,reject,23
320,168,152,103.0,3.62,12,3,university_of_california_irvine,reject,23
327,167,160,114.0,3.48,27,0,university_of_california_irvine,reject,23
320,168,152,111.0,3.28,0,0,university_of_california_irvine,reject,23
320,168,152,111.0,3.28,0,0,university_of_california_irvine,reject,23
321,169,152,102.0,2.97,18,0,university_of_california_irvine,reject,23
322,167,155,116.0,3.2,13,2,university_of_california_irvine,reject,23
310,164,146,102.0,2.62,28,0,university_of_california_irvine,reject,23
321,167,154,100.0,3.55,33,2,university_of_california_irvine,reject,23
318,165,153,106.0,3.0,29,0,university_of_california_irvine,reject,23
322,164,158,118.0,2.75,0,0,university_of_california_irvine,reject,23
324,170,154,0,3.19,2,0,university_of_california_irvine,reject,23
314,165,149,100.0,2.65,16,3,university_of_california_irvine,reject,23
316,168,148,98.0,3.04,16,2,university_of_california_irvine,reject,23
317,166,151,104.0,3.44,2,0,university_of_california_irvine,reject,23
323,167,156,110.0,3.0,29,0,university_of_california_irvine,reject,23
321,170,151,103.0,3.12,22,3,university_of_california_irvine,reject,23
327,170,157,116.0,3.68,6,0,university_of_california_irvine,reject,23
319,161,158,110.0,3.64,12,0,university_of_california_irvine,reject,23
322,170,152,0,2.98,21,0,university_of_california_irvine,reject,23
325,168,157,0,3.73,0,0,university_of_california_irvine,reject,23
314,166,148,100.0,3.66,11,3,university_of_california_irvine,reject,23
323,168,155,109.0,3.48,4,0,university_of_florida,accept,62
309,165,144,101,3.27,28,1,university_of_florida,accept,62
317,167,150,101,3.47,32,0,university_of_florida,accept,62
311,164,147,112.0,3.12,15,0,university_of_florida,accept,62
315,165,150,101,3.0,36,0,university_of_florida,accept,62
260,130,130,44.0,3.4,0,0,university_of_florida,accept,62
319,158,161,116.0,3.0,4,0,university_of_florida,accept,62
321,164,157,118.0,2.82,16,0,university_of_florida,accept,62
322,164,158,115.0,3.64,20,1,university_of_florida,accept,62
313,167,146,95.0,2.5,24,0,university_of_florida,accept,62
313,164,149,108.0,2.35,21,0,university_of_florida,accept,62
323,167,156,106.0,3.76,35,3,university_of_florida,accept,62
324,163,161,110.0,3.64,28,0,university_of_florida,accept,62
324,163,161,110.0,3.64,28,0,university_of_florida,accept,62
316,166,150,108.0,3.88,30,0,university_of_florida,accept,62
315,165,150,107.0,3.45,26,0,university_of_florida,accept,62
327,168,159,113.0,3.1,26,3,university_of_florida,accept,62
312,161,151,114,2.66,0,2,university_of_florida,accept,62
328,167,161,105.0,3.3,36,0,university_of_florida,accept,62
309,159,150,107.0,3.23,20,0,university_of_florida,accept,62
324,169,155,101.0,3.38,30,3,university_of_florida,accept,62
313,166,147,102.0,3.54,28,3,university_of_florida,accept,62
318,166,152,110.0,3.14,6,0,university_of_florida,accept,62
316,166,150,102.0,3.51,0,0,university_of_florida,accept,62
311,162,149,99.0,2.95,0,3,university_of_florida,accept,62
324,158,166,109.0,3.36,0,0,university_of_florida,accept,62
315,160,155,106.0,3.0,34,0,university_of_florida,accept,62
315,161,154,106.0,3.08,6,0,university_of_florida,accept,62
311,161,150,102.0,3.66,16,0,university_of_florida,accept,62
327,166,161,108.0,3.48,28,0,university_of_florida,accept,62
319,167,152,104.0,2.94,0,0,university_of_florida,accept,62
323,163,160,118.0,3.72,1,3,university_of_florida,accept,62
322,170,152,108.0,3.26,16,2,university_of_florida,accept,62
327,169,158,107.0,3.45,31,0,university_of_florida,accept,62
320,169,151,115.0,2.84,16,1,university_of_florida,accept,62
312,160,152,102.0,3.14,1,3,university_of_florida,accept,62
317,165,152,114,3.25,2,0,university_of_florida,accept,62
322,163,159,114.0,3.04,6,3,university_of_florida,accept,62
324,163,161,108.0,3.53,1,0,university_of_florida,accept,62
323,167,156,112.0,3.14,6,0,university_of_florida,accept,62
318,169,149,104.0,3.41,0,0,university_of_florida,accept,62
323,166,157,110.0,2.83,0,0,university_of_florida,accept,62
313,160,153,99.0,3.28,1,0,university_of_florida,accept,62
321,166,155,103.0,3.76,11,3,university_of_florida,accept,62
320,158,162,112.0,3.03,25,2,university_of_florida,accept,62
323,170,153,112.0,3.13,33,0,university_of_florida,accept,62
332,167,165,111.0,2.6,19,0,university_of_florida,accept,62
321,164,157,110.0,1.21,4,3,university_of_florida,accept,62
316,164,152,105.0,3.37,19,1,university_of_florida,accept,62
312,166,146,108.0,3.7,2,0,university_of_florida,accept,62
329,163,166,104.0,2.85,10,2,university_of_florida,accept,62
317,162,155,111.0,3.24,1,0,university_of_florida,accept,62
321,162,159,102.0,3.18,0,3,university_of_florida,accept,62
318,165,153,118.0,3.55,0,3,university_of_florida,accept,62
325,165,160,108.0,3.16,2,0,university_of_florida,accept,62
325,165,160,108.0,3.16,2,0,university_of_florida,accept,62
328,169,159,109.0,3.26,9,2,university_of_florida,accept,62
309,160,149,99.0,3.4,1,0,university_of_florida,accept,62
316,164,152,101.0,3.46,0,0,university_of_florida,accept,62
314,165,149,108.0,2.99,5,3,university_of_florida,accept,62
312,162,150,101,2.94,20,3,university_of_florida,reject,62
312,162,150,101,2.94,20,3,university_of_florida,reject,62
317,165,152,110.0,2.45,0,0,university_of_florida,reject,62
317,167,150,105.0,3.56,41,0,university_of_florida,reject,62
318,170,148,112.0,2.89,0,0,university_of_florida,reject,62
312,160,152,101,3.0,33,2,university_of_florida,reject,62
311,158,153,85.0,2.8,29,2,university_of_florida,reject,62
316,166,150,104.0,2.64,27,0,university_of_florida,reject,62
314,166,148,93.0,3.04,21,0,university_of_florida,reject,62
316,153,163,105.0,2.96,24,0,university_of_florida,reject,62
320,163,157,108.0,3.32,26,0,university_of_florida,reject,62
311,162,149,101.0,2.33,25,0,university_of_florida,reject,62
326,167,159,112.0,3.35,21,0,university_of_florida,reject,62
312,164,148,87.0,3.52,3,0,university_of_florida,reject,62
311,162,149,101,2.89,18,0,university_of_florida,reject,62
313,169,144,100.0,3.07,20,0,university_of_florida,reject,62
326,170,156,110.0,2.92,0,0,university_of_florida,reject,62
308,163,145,102.0,3.28,4,0,university_of_florida,reject,62
308,163,145,102.0,3.28,4,0,university_of_florida,reject,62
317,161,156,106.0,2.01,0,0,university_of_florida,reject,62
319,170,149,97.0,3.24,5,0,university_of_florida,reject,62
318,167,151,108.0,2.94,24,0,university_of_florida,reject,62
314,164,150,90.0,2.3,42,0,university_of_florida,reject,62
314,163,151,101,3.27,27,0,university_of_florida,reject,62
312,162,150,102.0,2.52,30,3,university_of_florida,reject,62
315,164,151,109.0,3.28,1,0,university_of_florida,reject,62
304,155,149,107.0,2.92,22,0,university_of_florida,reject,62
327,170,157,111.0,3.18,38,0,university_of_florida,reject,62
311,164,147,102.0,2.45,8,0,university_of_florida,reject,62
307,159,148,106.0,3.36,0,3,university_of_florida,reject,62
304,160,144,96.0,3.14,0,0,university_of_florida,reject,62
314,160,154,112.0,2.92,18,0,university_of_florida,reject,62
310,161,149,96.0,3.55,55,3,university_of_florida,reject,62
306,161,145,93.0,3.36,0,0,university_of_florida,reject,62
315,159,156,101.0,2.81,2,3,university_of_florida,reject,62
314,165,149,75.0,3.36,36,0,university_of_north_carolina_at_charlotte,accept,30
314,165,149,75.0,3.36,36,0,university_of_north_carolina_at_charlotte,accept,30
310,164,146,92.0,3.0,28,0,university_of_north_carolina_at_charlotte,accept,30
310,164,146,94.0,3.2,5,0,university_of_north_carolina_at_charlotte,accept,30
307,163,144,91.0,3.5,17,0,university_of_north_carolina_at_charlotte,accept,30
312,160,152,100.0,3.64,0,3,university_of_north_carolina_at_charlotte,accept,30
308,159,149,90.0,2.4,42,0,university_of_north_carolina_at_charlotte,accept,30
306,157,149,100.0,3.56,20,0,university_of_north_carolina_at_charlotte,accept,30
306,160,146,84.0,2.94,0,1,university_of_north_carolina_at_charlotte,accept,30
296,160,136,65.0,2.67,30,0,university_of_north_carolina_at_charlotte,accept,30
313,168,145,101.0,3.14,0,0,university_of_north_carolina_at_charlotte,accept,30
304,160,144,96.0,3.14,0,0,university_of_north_carolina_at_charlotte,accept,30
305,159,146,98.0,2.7,3,2,university_of_north_carolina_at_charlotte,accept,30
322,167,155,103.0,3.08,20,3,university_of_north_carolina_at_charlotte,accept,30
324,170,154,105.0,2.8,0,0,university_of_north_carolina_at_charlotte,accept,30
324,170,154,105.0,2.8,0,0,university_of_north_carolina_at_charlotte,accept,30
298,157,141,101,3.52,34,0,university_of_north_carolina_at_charlotte,accept,30
304,162,142,65.0,3.38,20,3,university_of_north_carolina_at_charlotte,accept,30
299,157,142,87.0,2.75,60,0,university_of_north_carolina_at_charlotte,accept,30
308,157,151,102.0,2.94,21,0,university_of_north_carolina_at_charlotte,accept,30
289,156,133,101,3.67,16,0,university_of_north_carolina_at_charlotte,accept,30
314,165,149,102.0,2.8,20,0,university_of_north_carolina_at_charlotte,accept,30
305,161,144,95.0,3.23,4,0,university_of_north_carolina_at_charlotte,accept,30
298,160,138,91.0,3.24,31,0,university_of_north_carolina_at_charlotte,accept,30
307,158,149,89.0,3.02,32,3,university_of_north_carolina_at_charlotte,accept,30
311,158,153,104.0,2.45,18,0,university_of_north_carolina_at_charlotte,accept,30
307,158,149,89.0,2.0,15,0,university_of_north_carolina_at_charlotte,accept,30
306,158,148,92.0,2.49,0,0,university_of_north_carolina_at_charlotte,accept,30
304,155,149,99.0,2.45,37,0,university_of_north_carolina_at_charlotte,accept,30
290,149,141,95.0,3.8,36,0,university_of_north_carolina_at_charlotte,accept,30
315,167,148,98.0,3.39,0,0,university_of_north_carolina_at_charlotte,accept,30
305,163,142,101,3.67,0,0,university_of_north_carolina_at_charlotte,accept,30
310,161,149,97.0,2.65,2,0,university_of_north_carolina_at_charlotte,accept,30
304,160,144,90.0,2.2,20,3,university_of_north_carolina_at_charlotte,accept,30
300,155,145,65.0,2.4,6,3,university_of_north_carolina_at_charlotte,accept,30
309,163,146,65.0,3.2,12,0,university_of_north_carolina_at_charlotte,accept,30
315,160,155,111.0,3.34,5,0,university_of_north_carolina_at_charlotte,accept,30
309,159,150,94.0,3.25,0,0,university_of_north_carolina_at_charlotte,accept,30
306,156,150,86.0,2.36,36,0,university_of_north_carolina_at_charlotte,accept,30
313,161,152,75.0,3.49,19,2,university_of_north_carolina_at_charlotte,accept,30
307,163,144,101,3.43,4,0,university_of_north_carolina_at_charlotte,accept,30
308,162,146,95.0,3.44,31,0,university_of_north_carolina_at_charlotte,accept,30
316,164,152,98.0,2.88,33,1,university_of_north_carolina_at_charlotte,accept,30
303,161,142,89.0,3.45,45,0,university_of_north_carolina_at_charlotte,accept,30
313,163,150,93.0,2.8,23,0,university_of_north_carolina_at_charlotte,accept,30
307,157,150,119.0,3.21,82,0,university_of_north_carolina_at_charlotte,accept,30
296,160,136,86.0,3.1,0,0,university_of_north_carolina_at_charlotte,accept,30
302,155,147,65.0,2.99,0,0,university_of_north_carolina_at_charlotte,accept,30
315,161,154,104.0,2.18,4,1,university_of_north_carolina_at_charlotte,accept,30
300,153,147,101,2.25,1,1,university_of_north_carolina_at_charlotte,accept,30
323,161,162,106.0,2.75,39,0,university_of_north_carolina_at_charlotte,accept,30
313,164,149,97.0,2.85,5,0,university_of_north_carolina_at_charlotte,accept,30
304,158,146,101,3.48,20,3,university_of_north_carolina_at_charlotte,accept,30
305,160,145,75.0,3.85,12,0,university_of_north_carolina_at_charlotte,accept,30
305,153,152,107.0,2.75,24,0,university_of_north_carolina_at_charlotte,accept,30
297,160,137,89.0,3.52,0,3,university_of_north_carolina_at_charlotte,accept,30
297,155,142,86.0,3.22,24,0,university_of_north_carolina_at_charlotte,accept,30
307,160,147,100.0,3.76,7,1,university_of_north_carolina_at_charlotte,accept,30
311,166,145,75.0,3.07,50,0,university_of_north_carolina_at_charlotte,accept,30
306,148,158,94.0,2.69,48,2,university_of_north_carolina_at_charlotte,accept,30
314,161,153,99.0,3.36,0,0,university_of_north_carolina_at_charlotte,accept,30
314,161,153,99.0,3.36,0,0,university_of_north_carolina_at_charlotte,accept,30
301,159,142,85.0,3.15,20,2,university_of_north_carolina_at_charlotte,accept,30
318,166,152,110.0,3.5,53,3,university_of_north_carolina_at_charlotte,accept,30
297,154,143,101,2.46,14,0,university_of_north_carolina_at_charlotte,accept,30
304,158,146,65.0,3.4,41,0,university_of_north_carolina_at_charlotte,accept,30
314,166,148,115.0,2.55,36,3,university_of_north_carolina_at_charlotte,accept,30
304,164,140,65.0,3.2,28,0,university_of_north_carolina_at_charlotte,accept,30
308,162,146,97.0,3.07,68,0,university_of_north_carolina_at_charlotte,accept,30
306,157,149,94.0,3.58,28,0,university_of_north_carolina_at_charlotte,accept,30
299,153,146,99.0,3.34,4,0,university_of_north_carolina_at_charlotte,accept,30
301,160,141,101,3.74,12,0,university_of_north_carolina_at_charlotte,accept,30
310,162,148,75.0,3.81,5,0,university_of_north_carolina_at_charlotte,accept,30
311,161,150,106.0,3.08,54,0,university_of_north_carolina_at_charlotte,accept,30
305,160,145,85.0,3.0,30,0,university_of_north_carolina_at_charlotte,accept,30
303,159,144,94.0,3.39,14,0,university_of_north_carolina_at_charlotte,accept,30
303,159,144,94.0,3.39,14,0,university_of_north_carolina_at_charlotte,accept,30
295,158,137,84.0,2.86,21,0,university_of_north_carolina_at_charlotte,accept,30
305,167,138,65.0,3.02,10,0,university_of_north_carolina_at_charlotte,accept,30
316,168,148,101.0,3.08,12,0,university_of_north_carolina_at_charlotte,accept,30
311,157,154,104.0,2.58,1,3,university_of_north_carolina_at_charlotte,accept,30
308,160,148,98.0,2.1,0,0,university_of_north_carolina_at_charlotte,accept,30
300,152,148,104.0,2.35,26,0,university_of_north_carolina_at_charlotte,accept,30
308,161,147,105.0,2.92,1,0,university_of_north_carolina_at_charlotte,accept,30
301,152,149,87.0,2.68,33,0,university_of_north_carolina_at_charlotte,accept,30
308,159,149,98.0,2.2,29,0,university_of_north_carolina_at_charlotte,accept,30
295,147,148,92.0,3.44,24,0,university_of_north_carolina_at_charlotte,accept,30
308,161,147,101,3.4,12,0,university_of_north_carolina_at_charlotte,accept,30
301,154,147,99.0,2.92,0,0,university_of_north_carolina_at_charlotte,accept,30
303,160,143,91.0,2.05,0,3,university_of_north_carolina_at_charlotte,accept,30
303,160,143,91.0,2.05,0,3,university_of_north_carolina_at_charlotte,accept,30
309,163,146,93.0,2.87,3,3,university_of_north_carolina_at_charlotte,accept,30
319,166,153,108.0,3.21,21,3,university_of_north_carolina_at_charlotte,accept,30
315,159,156,101.0,2.81,2,3,university_of_north_carolina_at_charlotte,accept,30
302,158,144,93.0,2.0,0,2,university_of_north_carolina_at_charlotte,accept,30
302,160,142,90.0,3.08,15,0,university_of_north_carolina_at_charlotte,accept,30
298,162,136,92.0,2.65,4,0,university_of_north_carolina_at_charlotte,accept,30
304,159,145,96.0,2.55,0,0,university_of_north_carolina_at_charlotte,accept,30
304,154,150,96.0,2.95,17,0,university_of_north_carolina_at_charlotte,accept,30
309,162,147,94.0,3.23,14,0,university_of_north_carolina_at_charlotte,accept,30
318,163,155,90.0,1.8,48,0,university_of_north_carolina_at_charlotte,accept,30
315,168,147,100.0,2.8,24,0,university_of_north_carolina_at_charlotte,accept,30
295,155,140,92.0,2.23,43,0,university_of_north_carolina_at_charlotte,accept,30
303,162,141,65.0,3.7,40,0,university_of_north_carolina_at_charlotte,accept,30
301,160,141,65.0,3.65,14,0,university_of_north_carolina_at_charlotte,accept,30
305,162,143,93.0,3.27,2,3,university_of_north_carolina_at_charlotte,accept,30
307,162,145,96.0,2.74,25,0,university_of_north_carolina_at_charlotte,accept,30
308,160,148,102.0,2.81,0,0,university_of_north_carolina_at_charlotte,accept,30
313,160,153,102.0,2.55,60,0,university_of_north_carolina_at_charlotte,accept,30
301,158,143,91.0,3.65,9,0,university_of_north_carolina_at_charlotte,accept,30
310,160,150,100.0,3.1,36,2,university_of_north_carolina_at_charlotte,accept,30
305,157,148,102.0,3.69,0,0,university_of_north_carolina_at_charlotte,accept,30
311,162,149,93.0,2.95,0,0,university_of_north_carolina_at_charlotte,accept,30
318,168,150,101,2.92,12,0,university_of_north_carolina_at_charlotte,accept,30
312,157,155,110.0,2.8,38,0,university_of_north_carolina_at_charlotte,accept,30
306,158,148,93.0,3.52,0,0,university_of_north_carolina_at_charlotte,accept,30
308,161,147,96.0,3.34,5,0,university_of_north_carolina_at_charlotte,accept,30
308,161,147,102.0,2.72,0,0,university_of_north_carolina_at_charlotte,accept,30
313,164,149,90.0,3.28,15,1,university_of_north_carolina_at_charlotte,accept,30
313,158,155,107.0,2.93,60,0,university_of_north_carolina_at_charlotte,accept,30
315,162,153,106.0,2.37,26,3,university_of_north_carolina_at_charlotte,accept,30
305,156,149,88.0,3.35,25,0,university_of_north_carolina_at_charlotte,accept,30
316,160,156,103.0,2.7,16,1,university_of_north_carolina_at_charlotte,accept,30
316,164,152,98.0,2.88,31,0,university_of_north_carolina_at_charlotte,accept,30
311,159,152,101.0,3.25,15,0,university_of_north_carolina_at_charlotte,accept,30
312,160,152,90.0,2.7,0,3,university_of_north_carolina_at_charlotte,accept,30
315,161,154,107.0,2.3,36,0,university_of_north_carolina_at_charlotte,accept,30
312,156,156,109.0,2.77,26,0,university_of_north_carolina_at_charlotte,accept,30
308,162,146,85.0,2.56,36,0,university_of_north_carolina_at_charlotte,accept,30
312,161,151,100.0,2.76,35,0,university_of_north_carolina_at_charlotte,accept,30
322,155,167,109.0,3.0,20,3,university_of_north_carolina_at_charlotte,accept,30
319,168,151,106.0,2.05,38,0,university_of_north_carolina_at_charlotte,accept,30
318,163,155,108.0,2.35,6,2,university_of_north_carolina_at_charlotte,accept,30
301,157,144,89.0,2.95,25,1,university_of_north_carolina_at_charlotte,accept,30
326,164,162,111.0,2.4,3,2,university_of_north_carolina_at_charlotte,accept,30
314,166,148,75.0,3.1,0,0,university_of_north_carolina_at_charlotte,accept,30
309,161,148,100.0,2.62,60,0,university_of_north_carolina_at_charlotte,accept,30
309,161,148,100.0,2.62,60,0,university_of_north_carolina_at_charlotte,accept,30
313,162,151,95.0,3.2,0,0,university_of_north_carolina_at_charlotte,accept,30
310,161,149,101.0,2.5,27,0,university_of_north_carolina_at_charlotte,accept,30
300,155,145,90.0,2.5,45,0,university_of_north_carolina_at_charlotte,accept,30
305,141,164,88.0,2.97,0,0,university_of_north_carolina_at_charlotte,accept,30
315,161,154,100.0,2.26,44,3,university_of_north_carolina_at_charlotte,accept,30
304,157,147,75.0,3.64,21,0,university_of_north_carolina_at_charlotte,accept,30
311,162,149,96.0,3.08,24,3,university_of_north_carolina_at_charlotte,accept,30
312,160,152,102.0,2.96,6,0,university_of_north_carolina_at_charlotte,accept,30
325,165,160,114.0,3.75,9,0,university_of_north_carolina_at_charlotte,accept,30
299,153,146,101,3.06,22,0,university_of_north_carolina_at_charlotte,accept,30
309,164,145,105.0,3.59,2,0,university_of_north_carolina_at_charlotte,accept,30
305,153,152,111.0,3.0,1,0,university_of_north_carolina_at_charlotte,accept,30
303,160,143,65.0,3.0,0,0,university_of_north_carolina_at_charlotte,accept,30
310,162,148,99.0,3.12,27,0,university_of_north_carolina_at_charlotte,accept,30
304,162,142,101,3.09,6,0,university_of_north_carolina_at_charlotte,accept,30
315,166,149,99.0,3.08,12,0,university_of_north_carolina_at_charlotte,accept,30
315,166,149,99.0,3.08,12,0,university_of_north_carolina_at_charlotte,accept,30
302,161,141,86.0,2.84,0,0,university_of_north_carolina_at_charlotte,accept,30
304,160,144,99.0,2.52,13,0,university_of_north_carolina_at_charlotte,accept,30
312,158,154,107.0,3.03,0,2,university_of_north_carolina_at_charlotte,accept,30
295,158,137,65.0,2.64,24,0,university_of_north_carolina_at_charlotte,accept,30
311,165,146,96.0,2.9,24,0,university_of_north_carolina_at_charlotte,accept,30
309,164,145,98.0,2.35,24,0,university_of_north_carolina_at_charlotte,accept,30
303,157,146,94.0,3.36,13,0,university_of_north_carolina_at_charlotte,accept,30
319,162,157,112.0,1.9,60,0,university_of_north_carolina_at_charlotte,accept,30
319,166,153,104.0,2.49,42,0,university_of_north_carolina_at_charlotte,accept,30
310,165,145,90.0,2.51,57,0,university_of_north_carolina_at_charlotte,accept,30
294,154,140,86.0,3.6,12,0,university_of_north_carolina_at_charlotte,accept,30
296,152,144,101,2.78,27,0,university_of_north_carolina_at_charlotte,accept,30
331,169,162,114.0,2.72,8,0,university_of_north_carolina_at_charlotte,accept,30
318,165,153,103.0,2.15,3,0,university_of_north_carolina_at_charlotte,accept,30
299,156,143,101,2.1,0,0,university_of_north_carolina_at_charlotte,accept,30
299,156,143,101,2.1,0,0,university_of_north_carolina_at_charlotte,accept,30
319,165,154,75.0,2.65,0,0,university_of_north_carolina_at_charlotte,accept,30
307,165,142,82.0,1.75,30,0,university_of_north_carolina_at_charlotte,accept,30
304,159,145,65.0,3.0,30,0,university_of_north_carolina_at_charlotte,accept,30
320,162,158,107.0,3.03,28,0,university_of_north_carolina_at_charlotte,accept,30
302,161,141,90.0,2.48,0,0,university_of_north_carolina_at_charlotte,accept,30
299,156,143,65.0,2.8,16,0,university_of_north_carolina_at_charlotte,accept,30
304,158,146,65.0,2.8,0,0,university_of_north_carolina_at_charlotte,accept,30
311,164,147,102.0,3.02,27,3,university_of_north_carolina_at_charlotte,accept,30
307,161,146,88.0,3.26,12,0,university_of_north_carolina_at_charlotte,accept,30
312,161,151,96.0,2.86,36,0,university_of_north_carolina_at_charlotte,accept,30
303,159,144,94.0,2.0,18,3,university_of_north_carolina_at_charlotte,accept,30
308,158,150,97.0,3.24,57,0,university_of_north_carolina_at_charlotte,accept,30
307,160,147,101,2.81,0,0,university_of_north_carolina_at_charlotte,accept,30
303,159,144,92.0,3.15,26,0,university_of_north_carolina_at_charlotte,accept,30
292,153,139,84.0,2.1,3,0,university_of_north_carolina_at_charlotte,reject,30
292,153,139,84.0,2.1,3,0,university_of_north_carolina_at_charlotte,reject,30
311,161,150,100.0,3.06,6,2,university_of_north_carolina_at_charlotte,reject,30
294,162,132,65.0,2.91,20,0,university_of_north_carolina_at_charlotte,reject,30
302,165,137,101,2.75,7,0,university_of_north_carolina_at_charlotte,reject,30
302,165,137,101,2.75,7,0,university_of_north_carolina_at_charlotte,reject,30
298,155,143,101.0,3.08,0,0,university_of_north_carolina_at_charlotte,reject,30
300,151,149,101,2.72,32,0,university_of_north_carolina_at_charlotte,reject,30
301,160,141,91.0,2.05,0,0,university_of_north_carolina_at_charlotte,reject,30
306,160,146,65.0,3.3,0,0,university_of_north_carolina_at_charlotte,reject,30
314,158,156,114.0,2.37,40,0,university_of_north_carolina_at_charlotte,reject,30
302,160,142,101,2.96,33,0,university_of_north_carolina_at_charlotte,reject,30
303,156,147,75.0,2.94,8,0,university_of_north_carolina_at_charlotte,reject,30
305,162,143,104.0,3.17,28,2,university_of_north_carolina_at_charlotte,reject,30
307,152,155,110.0,3.18,1,1,university_of_north_carolina_at_charlotte,reject,30
308,159,149,95.0,3.36,14,0,university_of_north_carolina_at_charlotte,reject,30
302,162,140,101,3.52,22,0,university_of_north_carolina_at_charlotte,reject,30
302,162,140,101,3.52,22,0,university_of_north_carolina_at_charlotte,reject,30
290,151,139,86.0,2.05,46,0,university_of_north_carolina_at_charlotte,reject,30
303,157,146,65.0,2.8,0,0,university_of_north_carolina_at_charlotte,reject,30
314,166,148,75.0,2.85,2,0,university_of_north_carolina_at_charlotte,reject,30
304,163,141,101,3.38,2,0,university_of_north_carolina_at_charlotte,reject,30
295,158,137,65.0,3.05,2,0,university_of_north_carolina_at_charlotte,reject,30
310,164,146,65.0,3.03,0,0,university_of_north_carolina_at_charlotte,reject,30
305,160,145,105.0,2.52,6,0,university_of_north_carolina_at_charlotte,reject,30
314,163,151,95.0,2.51,60,0,university_of_north_carolina_at_charlotte,reject,30
302,156,146,94.0,3.52,23,0,university_of_north_carolina_at_charlotte,reject,30
299,157,142,75.0,3.25,2,0,university_of_north_carolina_at_charlotte,reject,30
305,160,145,65.0,2.38,41,0,university_of_north_carolina_at_charlotte,reject,30
315,164,151,114,2.55,23,0,university_of_north_carolina_at_charlotte,reject,30
300,153,147,65.0,2.75,4,0,university_of_north_carolina_at_charlotte,reject,30
305,158,147,94.0,3.23,0,3,university_of_north_carolina_at_charlotte,reject,30
313,162,151,95.0,2.92,10,2,university_of_north_carolina_at_charlotte,reject,30
301,155,146,114,2.05,6,0,university_of_north_carolina_at_charlotte,reject,30
301,155,146,114,2.05,6,0,university_of_north_carolina_at_charlotte,reject,30
302,151,151,104.0,2.83,3,3,university_of_north_carolina_at_charlotte,reject,30
299,151,148,101,3.0,35,0,university_of_north_carolina_at_charlotte,reject,30
312,168,144,88.0,2.45,30,0,university_of_north_carolina_at_charlotte,reject,30
303,157,146,83.0,2.44,25,0,university_of_north_carolina_at_charlotte,reject,30
309,168,141,98.0,3.16,9,0,university_of_north_carolina_at_charlotte,reject,30
312,168,144,65.0,2.45,32,0,university_of_north_carolina_at_charlotte,reject,30
316,162,154,93.0,3.02,33,3,university_of_north_carolina_at_charlotte,reject,30
304,160,144,83.0,1.95,26,3,university_of_north_carolina_at_charlotte,reject,30
300,159,141,65.0,3.29,17,0,university_of_north_carolina_at_charlotte,reject,30
303,164,139,65.0,2.95,24,0,university_of_north_carolina_at_charlotte,reject,30
310,154,156,112.0,3.61,3,0,university_of_north_carolina_at_charlotte,reject,30
320,163,157,109.0,2.8,30,3,university_of_north_carolina_at_charlotte,reject,30
310,159,151,65.0,2.58,16,0,university_of_north_carolina_at_charlotte,reject,30
307,158,149,89.0,2.65,13,0,university_of_north_carolina_at_charlotte,reject,30
298,156,142,84.0,2.95,23,0,university_of_north_carolina_at_charlotte,reject,30
322,166,156,110.0,3.28,19,0,university_of_north_carolina_at_charlotte,reject,30
322,166,156,110.0,3.28,19,0,university_of_north_carolina_at_charlotte,reject,30
319,163,156,114,3.2,0,0,university_of_north_carolina_at_charlotte,reject,30
295,154,141,75.0,3.0,1,3,university_of_north_carolina_at_charlotte,reject,30
303,156,147,101,3.6,0,0,university_of_north_carolina_at_charlotte,reject,30
308,161,147,87.0,2.47,20,0,university_of_north_carolina_at_charlotte,reject,30
299,138,161,101,2.75,0,0,university_of_north_carolina_at_charlotte,reject,30
299,160,139,101,2.88,4,3,university_of_north_carolina_at_charlotte,reject,30
311,167,144,101.0,3.2,6,3,university_of_north_carolina_at_charlotte,reject,30
315,164,151,102.0,2.67,20,0,university_of_north_carolina_at_charlotte,reject,30
319,163,156,114,2.85,0,0,university_of_north_carolina_at_charlotte,reject,30
306,156,150,106.0,3.5,1,2,university_of_north_carolina_at_charlotte,reject,30
301,158,143,91.0,3.02,23,0,university_of_north_carolina_at_charlotte,reject,30
311,164,147,99.0,2.85,11,0,university_of_north_carolina_at_charlotte,reject,30
299,155,144,75.0,2.9,1,3,university_of_north_carolina_at_charlotte,reject,30
306,157,149,94.0,2.76,30,0,university_of_north_carolina_at_charlotte,reject,30
296,155,141,88.0,2.79,1,0,university_of_north_carolina_at_charlotte,reject,30
318,157,161,111.0,2.68,36,0,university_of_north_carolina_at_charlotte,reject,30
305,158,147,101,2.25,1,0,university_of_north_carolina_at_charlotte,reject,30
303,160,143,65.0,2.98,32,0,university_of_north_carolina_at_charlotte,reject,30
312,160,152,99.0,2.31,31,0,university_of_north_carolina_at_charlotte,reject,30
305,161,144,97.0,2.63,13,0,university_of_north_carolina_at_charlotte,reject,30
306,158,148,75.0,3.6,17,0,university_of_north_carolina_at_charlotte,reject,30
314,162,152,101.0,2.32,0,0,university_of_north_carolina_at_charlotte,reject,30
287,149,138,83.0,2.73,25,0,university_of_north_carolina_at_charlotte,reject,30
310,159,151,93.0,2.78,14,0,university_of_north_carolina_at_charlotte,reject,30
312,165,147,93.0,2.84,39,0,university_of_north_carolina_at_charlotte,reject,30
314,170,144,65.0,3.15,0,0,university_of_north_carolina_at_charlotte,reject,30
318,164,154,112.0,2.98,14,0,university_of_north_carolina_at_charlotte,reject,30
307,167,140,101,2.86,18,0,university_of_north_carolina_at_charlotte,reject,30
311,164,147,90.0,2.5,5,0,university_of_north_carolina_at_charlotte,reject,30
312,163,149,75.0,3.09,23,0,university_of_north_carolina_at_charlotte,reject,30
305,159,146,75.0,3.77,0,0,university_of_north_carolina_at_charlotte,reject,30
313,164,149,65.0,3.5,19,0,university_of_north_carolina_at_charlotte,reject,30
309,168,141,107.0,2.25,28,0,university_of_north_carolina_at_charlotte,reject,30
311,162,149,99.0,2.8,0,0,university_of_north_carolina_at_charlotte,reject,30
306,159,147,102.0,3.34,20,0,university_of_north_carolina_at_charlotte,reject,30
303,150,153,75.0,2.25,1,0,university_of_north_carolina_at_charlotte,reject,30
314,163,151,101,3.27,27,0,university_of_north_carolina_at_charlotte,reject,30
306,160,146,93.0,2.55,25,0,university_of_north_carolina_at_charlotte,reject,30
312,168,144,101,3.0,20,0,university_of_north_carolina_at_charlotte,reject,30
314,164,150,101.0,2.3,0,0,university_of_north_carolina_at_charlotte,reject,30
307,161,146,101,2.85,0,0,university_of_north_carolina_at_charlotte,reject,30
305,160,145,101,2.75,1,0,university_of_north_carolina_at_charlotte,reject,30
312,166,146,75.0,2.73,18,0,university_of_north_carolina_at_charlotte,reject,30
316,160,156,114,2.97,0,0,university_of_north_carolina_at_charlotte,reject,30
319,167,152,104.0,2.94,0,0,university_of_north_carolina_at_charlotte,reject,30
308,157,151,99.0,2.84,24,0,university_of_north_carolina_at_charlotte,reject,30
305,162,143,75.0,2.95,12,0,university_of_north_carolina_at_charlotte,reject,30
305,162,143,75.0,2.95,12,0,university_of_north_carolina_at_charlotte,reject,30
310,166,144,90.0,2.65,12,0,university_of_north_carolina_at_charlotte,reject,30
320,162,158,100.0,2.93,32,0,university_of_north_carolina_at_charlotte,reject,30
301,154,147,94.0,2.87,30,0,university_of_north_carolina_at_charlotte,reject,30
316,163,153,99.0,2.71,30,0,university_of_north_carolina_at_charlotte,reject,30
307,158,149,95.0,1.8,12,3,university_of_north_carolina_at_charlotte,reject,30
307,161,146,94.0,1.6,30,0,university_of_north_carolina_at_charlotte,reject,30
301,159,142,101,2.49,16,0,university_of_north_carolina_at_charlotte,reject,30
305,157,148,101,2.86,30,0,university_of_north_carolina_at_charlotte,reject,30
307,157,150,93.0,3.05,25,0,university_of_north_carolina_at_charlotte,reject,30
309,166,143,101,3.16,15,0,university_of_north_carolina_at_charlotte,reject,30
308,157,151,101,2.58,6,0,university_of_north_carolina_at_charlotte,reject,30
293,155,138,82.0,3.22,8,2,university_of_north_carolina_at_charlotte,reject,30
301,157,144,65.0,3.33,17,1,university_of_north_carolina_at_charlotte,reject,30
296,156,140,82.0,3.08,6,0,university_of_north_carolina_at_charlotte,reject,30
296,156,140,82.0,3.08,6,0,university_of_north_carolina_at_charlotte,reject,30
332,167,165,111.0,2.6,19,0,university_of_north_carolina_at_charlotte,reject,30
310,165,145,94.0,2.9,36,0,university_of_north_carolina_at_charlotte,reject,30
305,162,143,65.0,2.94,13,0,university_of_north_carolina_at_charlotte,reject,30
308,164,144,92.0,2.88,10,0,university_of_north_carolina_at_charlotte,reject,30
300,156,144,101,2.46,0,0,university_of_north_carolina_at_charlotte,reject,30
297,153,144,97.0,3.07,60,0,university_of_north_carolina_at_charlotte,reject,30
317,168,149,99.0,3.46,0,0,university_of_north_carolina_at_charlotte,reject,30
300,158,142,75.0,2.5,0,0,university_of_north_carolina_at_charlotte,reject,30
294,150,144,90.0,2.7,25,0,university_of_north_carolina_at_charlotte,reject,30
306,157,149,94.0,2.53,0,2,university_of_north_carolina_at_charlotte,reject,30
313,162,151,97.0,3.12,28,0,university_of_north_carolina_at_charlotte,reject,30
292,149,143,82.0,3.25,15,0,university_of_north_carolina_at_charlotte,reject,30
307,159,148,102.0,2.81,12,0,university_of_north_carolina_at_charlotte,reject,30
309,165,144,114,2.95,1,0,university_of_north_carolina_at_charlotte,reject,30
301,162,139,101,3.24,7,0,university_of_north_carolina_at_charlotte,reject,30
304,155,149,101,2.75,30,0,university_of_north_carolina_at_charlotte,reject,30
300,157,143,65.0,2.58,0,0,university_of_north_carolina_at_charlotte,reject,30
316,165,151,96.0,2.72,45,0,university_of_north_carolina_at_charlotte,reject,30
302,164,138,0,2.76,20,0,university_of_north_carolina_at_charlotte,reject,30
301,161,140,78,2.8,30,0,university_of_north_carolina_at_charlotte,reject,30
309,160,149,90.0,1.81,50,0,university_of_north_carolina_at_charlotte,reject,30
312,160,152,104.0,2.72,6,0,university_of_north_carolina_at_charlotte,reject,30
302,160,142,75.0,3.1,18,0,university_of_north_carolina_at_charlotte,reject,30
302,163,139,101,2.1,36,0,university_of_north_carolina_at_charlotte,reject,30
307,157,150,97.0,2.35,48,0,university_of_north_carolina_at_charlotte,reject,30
299,156,143,89.0,2.62,46,3,university_of_north_carolina_at_charlotte,reject,30
303,160,143,95.0,3.0,0,0,university_of_north_carolina_at_charlotte,reject,30
313,156,157,114,2.25,1,0,university_of_north_carolina_at_charlotte,reject,30
316,164,152,106.0,3.55,47,0,university_of_north_carolina_at_charlotte,reject,30
303,160,143,93.0,3.03,19,0,university_of_north_carolina_at_charlotte,reject,30
303,160,143,93.0,3.03,19,0,university_of_north_carolina_at_charlotte,reject,30
303,162,141,101,3.27,12,0,university_of_north_carolina_at_charlotte,reject,30
298,155,143,65.0,2.25,12,0,university_of_north_carolina_at_charlotte,reject,30
307,160,147,101,3.1,0,0,university_of_north_carolina_at_charlotte,reject,30
310,166,144,114,2.42,0,0,university_of_north_carolina_at_charlotte,reject,30
306,160,146,90.0,2.89,35,0,university_of_north_carolina_at_charlotte,reject,30
306,162,144,100.0,2.06,40,0,university_of_north_carolina_at_charlotte,reject,30
304,153,151,95.0,1.9,48,0,university_of_north_carolina_at_charlotte,reject,30
303,158,145,108.0,2.6,0,0,university_of_north_carolina_at_charlotte,reject,30
302,155,147,98.0,3.2,29,1,university_of_north_carolina_at_charlotte,reject,30
303,157,146,102.0,2.5,6,0,university_of_north_carolina_at_charlotte,reject,30
314,160,154,117.0,2.31,26,1,university_of_north_carolina_at_charlotte,reject,30
311,156,155,0,3.14,35,0,university_of_north_carolina_at_charlotte,reject,30
307,160,147,95.0,2.86,28,0,university_of_north_carolina_at_charlotte,reject,30
314,157,157,110.0,2.28,20,0,university_of_north_carolina_at_charlotte,reject,30
314,157,157,110.0,2.28,20,0,university_of_north_carolina_at_charlotte,reject,30
300,156,144,75.0,2.5,11,0,university_of_north_carolina_at_charlotte,reject,30
307,160,147,111.0,2.8,0,0,university_of_north_carolina_at_charlotte,reject,30
312,167,145,0,2.3,0,0,university_of_north_carolina_at_charlotte,reject,30
305,159,146,0,3.52,0,0,university_of_north_carolina_at_charlotte,reject,30
298,157,141,88.0,1.93,27,1,university_of_north_carolina_at_charlotte,reject,30
303,155,148,65.0,2.8,21,0,university_of_north_carolina_at_charlotte,reject,30
325,166,159,111.0,2.7,30,0,university_of_north_carolina_at_charlotte,reject,30
302,158,144,81.0,3.52,18,0,university_of_north_carolina_at_charlotte,reject,30
305,164,141,0,2.64,32,0,university_of_north_carolina_at_charlotte,reject,30
321,167,154,105.0,1.8,29,3,university_of_north_carolina_at_charlotte,reject,30
301,156,145,100.0,2.57,0,3,university_of_north_carolina_at_charlotte,reject,30
301,153,148,95.0,1.82,12,3,university_of_north_carolina_at_charlotte,reject,30
312,166,146,104.0,2.56,0,0,university_of_north_carolina_at_charlotte,reject,30
320,164,156,75.0,3.4,1,0,university_of_north_carolina_at_charlotte,reject,30
307,158,149,78,2.76,26,0,university_of_north_carolina_at_charlotte,reject,30
309,159,150,114,2.3,20,0,university_of_north_carolina_at_charlotte,reject,30
301,158,143,65.0,2.92,30,0,university_of_north_carolina_at_charlotte,reject,30
304,156,148,101.0,2.5,6,0,university_of_north_carolina_at_charlotte,reject,30
306,165,141,65.0,2.71,2,0,university_of_north_carolina_at_charlotte,reject,30
306,165,141,65.0,2.71,2,0,university_of_north_carolina_at_charlotte,reject,30
305,157,148,105.0,1.72,35,0,university_of_north_carolina_at_charlotte,reject,30
315,164,151,105.0,3.32,27,0,university_of_north_carolina_at_charlotte,reject,30
308,156,152,97.0,2.1,48,0,university_of_north_carolina_at_charlotte,reject,30
322,169,153,115.0,2.64,2,0,university_of_north_carolina_at_charlotte,reject,30
298,156,142,81.0,2.85,18,0,university_of_north_carolina_at_charlotte,reject,30
302,159,143,90.0,2.0,18,0,university_of_north_carolina_at_charlotte,reject,30
313,165,148,75.0,2.87,18,0,university_of_north_carolina_at_charlotte,reject,30
313,162,151,102.0,2.9,33,0,university_of_north_carolina_at_charlotte,reject,30
310,166,144,87.0,1.65,0,3,university_of_north_carolina_at_charlotte,reject,30
308,161,147,101.0,2.65,1,3,university_of_north_carolina_at_charlotte,reject,30
313,164,149,101,2.73,0,3,university_of_north_carolina_at_charlotte,reject,30
300,158,142,101,2.55,33,0,university_of_north_carolina_at_charlotte,reject,30
306,163,143,101.0,2.38,45,0,university_of_north_carolina_at_charlotte,reject,30
310,160,150,103.0,2.04,55,0,university_of_north_carolina_at_charlotte,reject,30
320,169,151,101.0,3.64,0,0,university_of_southern_california,accept,19
320,169,151,101.0,3.64,0,0,university_of_southern_california,accept,19
317,160,157,110.0,3.79,33,0,university_of_southern_california,accept,19
317,167,150,110.0,3.76,13,0,university_of_southern_california,accept,19
320,166,154,107.0,3.8,12,0,university_of_southern_california,accept,19
312,160,152,100.0,3.64,0,3,university_of_southern_california,accept,19
324,166,158,109.0,3.68,13,0,university_of_southern_california,accept,19
325,167,158,108.0,3.62,23,3,university_of_southern_california,accept,19
323,165,158,112.0,3.57,30,3,university_of_southern_california,accept,19
304,160,144,95.0,3.52,0,0,university_of_southern_california,accept,19
314,168,146,108.0,3.62,14,0,university_of_southern_california,accept,19
317,163,154,112.0,3.71,9,2,university_of_southern_california,accept,19
311,164,147,89.0,3.65,2,0,university_of_southern_california,accept,19
311,161,150,75.0,3.71,12,0,university_of_southern_california,accept,19
312,165,147,92.0,3.51,20,2,university_of_southern_california,accept,19
318,170,148,101.0,4.0,12,0,university_of_southern_california,accept,19
307,162,145,103.0,3.75,1,0,university_of_southern_california,accept,19
307,162,145,103.0,3.75,1,0,university_of_southern_california,accept,19
325,167,158,105.0,3.75,26,0,university_of_southern_california,accept,19
317,163,154,107.0,3.64,41,0,university_of_southern_california,accept,19
331,165,166,114.0,3.79,5,3,university_of_southern_california,accept,19
314,161,153,106.0,3.6,18,3,university_of_southern_california,accept,19
316,166,150,108.0,3.88,30,0,university_of_southern_california,accept,19
319,167,152,102.0,3.68,45,0,university_of_southern_california,accept,19
335,169,166,116.0,3.8,7,3,university_of_southern_california,accept,19
307,161,146,95.0,3.06,31,3,university_of_southern_california,accept,19
331,170,161,117.0,3.9,18,0,university_of_southern_california,accept,19
318,165,153,103.0,3.62,25,0,university_of_southern_california,accept,19
317,168,149,75.0,3.23,6,1,university_of_southern_california,reject,19
317,168,149,75.0,3.23,6,1,university_of_southern_california,reject,19
306,159,147,75.0,2.97,1,3,university_of_southern_california,reject,19
315,165,150,100.0,3.08,60,2,university_of_southern_california,reject,19
330,169,161,112.0,3.36,2,0,university_of_southern_california,reject,19
318,170,148,112.0,2.89,0,0,university_of_southern_california,reject,19
325,164,161,112.0,2.75,5,0,university_of_southern_california,reject,19
316,167,149,102.0,3.12,28,0,university_of_southern_california,reject,19
318,169,149,109.0,3.48,0,0,university_of_southern_california,reject,19
310,160,150,93.0,3.6,1,0,university_of_southern_california,reject,19
321,166,155,111.0,3.24,9,0,university_of_texas_arlington,accept,64
321,166,155,111.0,3.24,9,0,university_of_texas_arlington,accept,64
298,159,139,87.0,2.51,1,0,university_of_texas_arlington,accept,64
312,163,149,100.0,4.0,79,3,university_of_texas_arlington,accept,64
288,150,138,31,3.1,6,0,university_of_texas_arlington,accept,64
304,154,150,75.0,2.25,16,0,university_of_texas_arlington,accept,64
301,158,143,101,3.27,6,0,university_of_texas_arlington,accept,64
314,163,151,95.0,2.51,60,0,university_of_texas_arlington,accept,64
299,157,142,75.0,3.25,2,0,university_of_texas_arlington,accept,64
319,163,156,114,2.85,0,0,university_of_texas_arlington,accept,64
300,160,140,86.0,3.03,24,0,university_of_texas_arlington,accept,64
312,166,146,90.0,3.22,48,0,university_of_texas_arlington,accept,64
303,156,147,75.0,2.94,8,0,university_of_texas_arlington,accept,64
308,158,150,101,3.3,0,0,university_of_texas_arlington,accept,64
303,161,142,96.0,2.8,0,0,university_of_texas_arlington,accept,64
320,168,152,108.0,2.91,12,0,university_of_texas_arlington,accept,64
312,168,144,65.0,2.45,32,0,university_of_texas_arlington,accept,64
312,168,144,65.0,2.45,32,0,university_of_texas_arlington,accept,64
301,158,143,101,3.37,15,0,university_of_texas_arlington,accept,64
304,153,151,104.0,2.85,24,0,university_of_texas_arlington,accept,64
308,165,143,75.0,3.56,15,2,university_of_texas_arlington,accept,64
300,152,148,75.0,2.45,24,0,university_of_texas_arlington,accept,64
310,161,149,107.0,2.99,24,0,university_of_texas_arlington,accept,64
308,164,144,94.0,2.88,0,0,university_of_texas_arlington,accept,64
307,163,144,96.0,3.2,0,0,university_of_texas_arlington,accept,64
304,160,144,101,3.27,5,0,university_of_texas_arlington,accept,64
312,165,147,91.0,3.13,21,0,university_of_texas_arlington,accept,64
303,159,144,101,2.52,0,0,university_of_texas_arlington,accept,64
300,155,145,65.0,2.68,0,0,university_of_texas_arlington,accept,64
301,153,148,92.0,3.04,0,0,university_of_texas_arlington,accept,64
296,151,145,75.0,2.67,34,0,university_of_texas_arlington,accept,64
302,151,151,104.0,2.83,3,3,university_of_texas_arlington,accept,64
304,162,142,89.0,2.33,25,0,university_of_texas_arlington,accept,64
300,156,144,99.0,3.1,10,2,university_of_texas_arlington,accept,64
308,157,151,95.0,2.55,1,0,university_of_texas_arlington,accept,64
304,164,140,93.0,3.01,24,2,university_of_texas_arlington,accept,64
310,160,150,100.0,2.6,1,3,university_of_texas_arlington,accept,64
298,154,144,87.0,2.75,6,0,university_of_texas_arlington,accept,64
314,152,162,99.0,2.55,38,0,university_of_texas_arlington,accept,64
301,157,144,89.0,2.95,25,1,university_of_texas_arlington,accept,64
302,160,142,90.0,3.08,15,0,university_of_texas_arlington,accept,64
303,159,144,95.0,2.7,12,0,university_of_texas_arlington,accept,64
306,154,152,111.0,2.42,3,0,university_of_texas_arlington,accept,64
306,157,149,105.0,2.71,29,1,university_of_texas_arlington,accept,64
302,159,143,99.0,2.81,17,0,university_of_texas_arlington,accept,64
300,161,139,65.0,3.26,15,0,university_of_texas_arlington,accept,64
314,170,144,103.0,2.99,20,0,university_of_texas_arlington,accept,64
305,162,143,75.0,2.95,12,0,university_of_texas_arlington,accept,64
320,165,155,111.0,2.75,60,0,university_of_texas_arlington,accept,64
310,159,151,65.0,2.58,16,0,university_of_texas_arlington,accept,64
311,159,152,105.0,3.13,0,0,university_of_texas_arlington,accept,64
310,164,146,97.0,3.63,2,0,university_of_texas_arlington,accept,64
309,160,149,99.0,3.4,1,0,university_of_texas_arlington,accept,64
307,162,145,91.0,2.44,13,0,university_of_texas_arlington,accept,64
307,162,145,95.0,2.64,1,0,university_of_texas_arlington,accept,64
306,157,149,91.0,2.12,44,0,university_of_texas_arlington,accept,64
299,155,144,75.0,2.9,1,3,university_of_texas_arlington,accept,64
305,159,146,85.0,2.15,0,0,university_of_texas_arlington,accept,64
299,160,139,101,2.88,4,3,university_of_texas_arlington,accept,64
305,165,140,89.0,3.34,0,0,university_of_texas_arlington,accept,64
300,155,145,105.0,3.23,0,3,university_of_texas_arlington,accept,64
308,158,150,75.0,3.0,0,3,university_of_texas_arlington,accept,64
303,157,146,89.0,2.7,0,0,university_of_texas_arlington,accept,64
296,152,144,98.0,3.36,9,3,university_of_texas_arlington,accept,64
296,152,144,98.0,3.36,9,3,university_of_texas_arlington,accept,64
305,162,143,107.0,2.75,5,0,university_of_texas_arlington,accept,64
303,157,146,65.0,2.8,0,0,university_of_texas_arlington,accept,64
305,156,149,114,3.0,28,3,university_of_texas_arlington,accept,64
305,159,146,100.0,2.83,0,0,university_of_texas_arlington,accept,64
313,168,145,101.0,3.14,0,0,university_of_texas_arlington,accept,64
328,169,159,116.0,2.94,4,0,university_of_texas_arlington,accept,64
305,159,146,65.0,2.6,47,3,university_of_texas_arlington,accept,64
308,159,149,96.0,3.6,8,0,university_of_texas_arlington,accept,64
308,159,149,108.0,3.04,0,0,university_of_texas_arlington,accept,64
301,158,143,91.0,3.65,9,0,university_of_texas_arlington,accept,64
305,156,149,92.0,2.78,15,3,university_of_texas_arlington,accept,64
308,158,150,94.0,2.63,16,3,university_of_texas_arlington,accept,64
315,168,147,100.0,2.8,24,0,university_of_texas_arlington,accept,64
311,159,152,104.0,3.1,21,3,university_of_texas_arlington,accept,64
310,163,147,101,2.76,18,0,university_of_texas_arlington,accept,64
305,141,164,88.0,2.97,0,0,university_of_texas_arlington,accept,64
305,141,164,88.0,2.97,0,0,university_of_texas_arlington,accept,64
307,155,152,97.0,2.6,1,0,university_of_texas_arlington,accept,64
303,155,148,105.0,2.15,5,2,university_of_texas_arlington,accept,64
284,145,139,101,2.85,25,0,university_of_texas_arlington,accept,64
299,153,146,101,3.06,22,0,university_of_texas_arlington,accept,64
307,156,151,101,3.22,2,1,university_of_texas_arlington,accept,64
296,158,138,84.0,3.62,4,3,university_of_texas_arlington,accept,64
308,160,148,102.0,2.81,0,0,university_of_texas_arlington,accept,64
308,160,148,109.0,3.72,5,3,university_of_texas_arlington,accept,64
303,154,149,103.0,2.8,60,0,university_of_texas_arlington,accept,64
305,159,146,82.0,2.15,60,0,university_of_texas_arlington,accept,64
308,161,147,101,3.13,12,0,university_of_texas_arlington,accept,64
300,157,143,75.0,2.58,0,0,university_of_texas_arlington,accept,64
301,156,145,65.0,2.85,42,0,university_of_texas_arlington,accept,64
304,156,148,113.0,3.04,12,0,university_of_texas_arlington,accept,64
302,157,145,101,2.2,0,0,university_of_texas_arlington,accept,64
299,155,144,101,2.65,40,0,university_of_texas_arlington,accept,64
305,157,148,101,2.25,0,0,university_of_texas_arlington,accept,64
320,160,160,82.0,3.45,10,0,university_of_texas_arlington,accept,64
306,158,148,101,3.11,14,3,university_of_texas_arlington,accept,64
310,159,151,75.0,2.88,58,0,university_of_texas_arlington,accept,64
302,157,145,65.0,2.42,15,0,university_of_texas_arlington,accept,64
297,152,145,114,2.3,67,0,university_of_texas_arlington,accept,64
304,155,149,75.0,2.98,21,0,university_of_texas_arlington,accept,64
302,155,147,101,3.05,0,0,university_of_texas_arlington,accept,64
305,158,147,82.0,2.97,25,3,university_of_texas_arlington,accept,64
305,164,141,101,3.3,34,0,university_of_texas_arlington,accept,64
308,158,150,97.0,3.24,57,0,university_of_texas_arlington,accept,64
309,165,144,100.0,2.8,17,0,university_of_texas_arlington,accept,64
318,167,151,106.0,3.4,18,0,university_of_texas_arlington,accept,64
313,158,155,102.0,2.5,50,0,university_of_texas_arlington,accept,64
319,165,154,75.0,2.65,0,0,university_of_texas_arlington,accept,64
305,153,152,106.0,3.04,13,3,university_of_texas_arlington,accept,64
306,162,144,101,2.84,3,0,university_of_texas_arlington,accept,64
288,151,137,65.0,2.45,7,0,university_of_texas_arlington,accept,64
303,160,143,101,2.1,0,0,university_of_texas_arlington,accept,64
296,157,139,65.0,3.11,50,0,university_of_texas_arlington,accept,64
300,144,156,90.0,2.8,1,1,university_of_texas_arlington,accept,64
319,163,156,110.0,2.88,2,0,university_of_texas_arlington,accept,64
300,160,140,65.0,2.78,0,0,university_of_texas_arlington,accept,64
311,159,152,114,2.31,14,0,university_of_texas_arlington,accept,64
311,159,152,114,2.31,14,0,university_of_texas_arlington,accept,64
312,165,147,65.0,3.21,0,0,university_of_texas_arlington,accept,64
319,162,157,112.0,1.9,60,0,university_of_texas_arlington,accept,64
296,152,144,101,3.24,40,0,university_of_texas_arlington,accept,64
305,160,145,99.0,2.52,33,0,university_of_texas_arlington,accept,64
306,155,151,75.0,3.2,0,2,university_of_texas_arlington,accept,64
301,160,141,89.0,2.1,39,2,university_of_texas_arlington,accept,64
302,155,147,90.0,2.82,46,0,university_of_texas_arlington,accept,64
303,161,142,85.0,3.25,33,0,university_of_texas_arlington,accept,64
299,159,140,101,3.13,20,0,university_of_texas_arlington,accept,64
315,155,160,112.0,2.4,5,0,university_of_texas_arlington,accept,64
302,159,143,65.0,2.62,0,0,university_of_texas_arlington,accept,64
303,162,141,85.0,2.55,3,2,university_of_texas_arlington,accept,64
289,153,136,65.0,3.04,0,2,university_of_texas_arlington,accept,64
304,164,140,75.0,3.1,26,0,university_of_texas_arlington,accept,64
304,164,140,75.0,3.1,26,0,university_of_texas_arlington,accept,64
317,163,154,99.0,2.15,60,0,university_of_texas_arlington,accept,64
310,161,149,65.0,3.58,27,0,university_of_texas_arlington,accept,64
308,168,140,101,3.05,20,0,university_of_texas_arlington,accept,64
304,161,143,65.0,3.14,6,0,university_of_texas_arlington,accept,64
303,154,149,93.0,2.82,0,0,university_of_texas_arlington,accept,64
313,161,152,104.0,2.5,8,3,university_of_texas_arlington,accept,64
318,159,159,106.0,2.2,36,1,university_of_texas_arlington,accept,64
308,161,147,75.0,2.2,19,0,university_of_texas_arlington,accept,64
320,165,155,86.0,2.73,30,0,university_of_texas_arlington,accept,64
303,164,139,65.0,3.37,36,0,university_of_texas_arlington,accept,64
299,161,138,65.0,3.47,46,0,university_of_texas_arlington,accept,64
309,160,149,90.0,1.81,50,0,university_of_texas_arlington,accept,64
309,160,149,90.0,1.81,50,0,university_of_texas_arlington,accept,64
304,156,148,75.0,1.95,42,0,university_of_texas_arlington,accept,64
294,150,144,90.0,2.7,25,0,university_of_texas_arlington,accept,64
308,157,151,101.0,3.18,0,1,university_of_texas_arlington,accept,64
302,156,146,103.0,2.2,39,0,university_of_texas_arlington,accept,64
300,155,145,75.0,2.84,0,0,university_of_texas_arlington,accept,64
302,161,141,88.0,3.22,21,0,university_of_texas_arlington,accept,64
302,160,142,75.0,3.1,18,0,university_of_texas_arlington,accept,64
306,162,144,90.0,2.65,6,0,university_of_texas_arlington,accept,64
292,142,150,95.0,2.89,18,0,university_of_texas_arlington,accept,64
300,152,148,97.0,2.7,5,0,university_of_texas_arlington,accept,64
298,152,146,88.0,3.37,42,0,university_of_texas_arlington,accept,64
311,165,146,87.0,2.97,1,0,university_of_texas_arlington,accept,64
295,152,143,97.0,3.14,0,0,university_of_texas_arlington,accept,64
295,153,142,101,2.35,31,0,university_of_texas_arlington,accept,64
324,170,154,108.0,3.16,22,3,university_of_texas_arlington,accept,64
308,163,145,90.0,2.52,32,0,university_of_texas_arlington,accept,64
291,153,138,65.0,3.42,50,0,university_of_texas_arlington,accept,64
287,148,139,89.0,2.38,23,0,university_of_texas_arlington,accept,64
298,155,143,101,2.4,13,0,university_of_texas_arlington,accept,64
298,159,139,65.0,2.97,0,0,university_of_texas_arlington,accept,64
304,156,148,93.0,2.15,15,0,university_of_texas_arlington,accept,64
288,149,139,84.0,2.84,0,3,university_of_texas_arlington,accept,64
295,157,138,94.0,2.76,0,0,university_of_texas_arlington,accept,64
309,163,146,90.0,3.05,5,3,university_of_texas_arlington,accept,64
312,161,151,109.0,2.24,52,0,university_of_texas_arlington,accept,64
300,158,142,75.0,2.5,0,0,university_of_texas_arlington,accept,64
301,151,150,94.0,2.65,6,0,university_of_texas_arlington,accept,64
296,160,136,65.0,3.07,22,0,university_of_texas_arlington,reject,64
296,160,136,65.0,3.07,22,0,university_of_texas_arlington,reject,64
310,161,149,103.0,2.7,20,3,university_of_texas_arlington,reject,64
307,160,147,83.0,2.24,19,0,university_of_texas_arlington,reject,64
297,155,142,69.0,2.1,12,3,university_of_texas_arlington,reject,64
300,153,147,65.0,2.75,4,0,university_of_texas_arlington,reject,64
295,151,144,101,2.0,31,0,university_of_texas_arlington,reject,64
292,151,141,90.0,2.75,21,0,university_of_texas_arlington,reject,64
315,162,153,105.0,2.53,40,0,university_of_texas_arlington,reject,64
298,161,137,65.0,3.02,0,0,university_of_texas_arlington,reject,64
296,148,148,101,2.56,2,3,university_of_texas_arlington,reject,64
305,145,160,101.0,1.95,50,2,university_of_texas_arlington,reject,64
302,160,142,100.0,2.92,4,3,university_of_texas_arlington,reject,64
310,159,151,101.0,3.4,6,3,university_of_texas_arlington,reject,64
293,148,145,81.0,3.01,54,0,university_of_texas_arlington,reject,64
293,151,142,65.0,3.16,6,0,university_of_texas_arlington,reject,64
307,159,148,65.0,1.85,0,0,university_of_texas_arlington,reject,64
307,159,148,65.0,1.85,0,0,university_of_texas_arlington,reject,64
293,157,136,87.0,2.0,15,0,university_of_texas_arlington,reject,64
305,153,152,75.0,2.12,0,0,university_of_texas_arlington,reject,64
293,155,138,101,2.25,0,0,university_of_texas_arlington,reject,64
300,155,145,95.0,3.14,18,1,university_of_texas_arlington,reject,64
307,156,151,101.0,2.93,14,3,university_of_texas_arlington,reject,64
309,158,151,0,2.48,60,0,university_of_texas_arlington,reject,64
293,156,137,79.0,2.0,63,0,university_of_texas_arlington,reject,64
295,160,135,65.0,2.75,0,0,university_of_texas_arlington,reject,64
300,162,138,65.0,2.35,0,0,university_of_texas_arlington,reject,64
297,154,143,82.0,2.15,0,3,university_of_texas_arlington,reject,64
293,146,147,101,2.05,5,1,university_of_texas_arlington,reject,64
292,157,135,80.0,2.89,6,3,university_of_texas_arlington,reject,64
297,155,142,87.0,2.55,49,0,university_of_texas_arlington,reject,64
309,165,144,114,2.95,1,0,university_of_texas_arlington,reject,64
300,153,147,90.0,2.48,30,0,university_of_texas_arlington,reject,64
295,158,137,0,2.1,28,2,university_of_texas_arlington,reject,64
303,155,148,82.0,2.17,0,0,university_of_texas_arlington,reject,64
297,156,141,82.0,1.9,19,0,university_of_texas_arlington,reject,64
303,163,140,101,2.25,0,0,university_of_texas_arlington,reject,64
300,161,139,75.0,2.68,12,0,university_of_texas_arlington,reject,64
307,156,151,88.0,2.38,85,0,university_of_texas_arlington,reject,64
304,156,148,104.0,2.7,25,0,university_of_texas_arlington,reject,64
299,157,142,80.0,2.32,2,0,university_of_texas_arlington,reject,64
299,153,146,0,3.02,0,0,university_of_texas_arlington,reject,64
297,156,141,83.0,2.5,0,0,university_of_texas_arlington,reject,64
305,160,145,88.0,2.35,60,1,university_of_texas_arlington,reject,64
298,156,142,81.0,2.85,18,0,university_of_texas_arlington,reject,64
302,163,139,87.0,3.1,44,0,university_of_texas_arlington,reject,64
313,162,151,102.0,2.9,33,0,university_of_texas_arlington,reject,64
298,150,148,102.0,2.69,5,0,university_of_texas_arlington,reject,64
303,161,142,101,2.3,5,0,university_of_texas_arlington,reject,64
300,156,144,83.0,2.96,35,0,university_of_texas_arlington,reject,64
315,161,154,107.0,2.02,60,0,university_of_texas_arlington,reject,64
301,159,142,65.0,3.01,0,1,university_of_texas_arlington,reject,64
296,155,141,82.0,2.75,15,0,university_of_texas_arlington,reject,64
306,158,148,93.0,2.34,0,0,university_of_texas_arlington,reject,64
306,158,148,93.0,2.34,0,0,university_of_texas_arlington,reject,64
314,159,155,75.0,2.85,23,0,university_of_texas_arlington,reject,64
313,168,145,95.0,1.9,7,1,university_of_texas_arlington,reject,64
302,161,141,101,2.58,0,0,university_of_texas_arlington,reject,64
308,160,148,82.0,2.92,3,0,university_of_texas_arlington,reject,64
299,158,141,78,3.36,16,0,university_of_texas_arlington,reject,64
295,155,140,65.0,2.26,12,0,university_of_texas_arlington,reject,64
304,155,149,80.0,3.06,20,0,university_of_texas_arlington,reject,64
300,159,141,78,2.5,0,0,university_of_texas_arlington,reject,64
304,158,146,85.0,2.45,90,0,university_of_texas_arlington,reject,64
305,163,142,90.0,3.46,24,0,university_of_texas_arlington,reject,64
301,158,143,86.0,1.9,30,0,university_of_texas_arlington,reject,64
303,160,143,97.0,2.0,0,2,university_of_texas_arlington,reject,64
307,160,147,75.0,2.55,0,3,university_of_texas_arlington,reject,64
293,151,142,88.0,1.94,6,0,university_of_texas_arlington,reject,64
302,161,141,96.0,3.52,30,3,university_of_texas_arlington,reject,64
310,161,149,91.0,2.78,0,0,university_of_texas_arlington,reject,64
310,161,149,91.0,2.78,0,0,university_of_texas_arlington,reject,64
299,152,147,85.0,1.93,60,0,university_of_texas_arlington,reject,64
300,144,156,82.0,2.75,0,0,university_of_texas_arlington,reject,64
317,167,150,92.0,1.95,2,0,university_of_texas_arlington,reject,64
300,154,146,88.0,1.79,18,0,university_of_texas_arlington,reject,64
298,157,141,84.0,2.5,60,0,university_of_texas_arlington,reject,64
294,151,143,91.0,2.8,0,0,university_of_texas_arlington,reject,64
296,154,142,92.0,2.55,24,0,university_of_texas_arlington,reject,64
306,164,142,110.0,2.39,17,0,university_of_texas_arlington,reject,64
297,152,145,94.0,2.49,30,0,university_of_texas_arlington,reject,64
298,153,145,87.0,2.81,0,0,university_of_texas_arlington,reject,64
308,159,149,101,3.29,10,0,university_of_texas_arlington,reject,64
290,151,139,85.0,2.55,20,3,university_of_texas_arlington,reject,64
302,157,145,75.0,2.75,12,0,university_of_texas_arlington,reject,64
298,154,144,94.0,2.92,6,0,university_of_texas_arlington,reject,64
300,156,144,84.0,1.85,10,1,university_of_texas_arlington,reject,64
300,156,144,84.0,1.85,10,1,university_of_texas_arlington,reject,64
304,160,144,87.0,3.04,3,0,university_of_texas_arlington,reject,64
317,167,150,75.0,2.4,9,0,university_of_texas_arlington,reject,64
304,166,138,83.0,3.48,10,0,university_of_texas_arlington,reject,64
294,154,140,95.0,2.5,6,0,university_of_texas_arlington,reject,64
304,162,142,91.0,3.35,0,0,university_of_texas_arlington,reject,64
309,160,149,100.0,2.4,30,2,university_of_texas_arlington,reject,64
300,158,142,91.0,3.04,15,3,university_of_texas_arlington,reject,64
295,152,143,85.0,2.7,0,0,university_of_texas_arlington,reject,64
305,163,142,83.0,2.8,24,0,university_of_texas_arlington,reject,64
300,158,142,80.0,3.14,3,0,university_of_texas_arlington,reject,64
307,161,146,97.0,1.8,21,0,university_of_texas_arlington,reject,64
309,162,147,97.0,2.2,12,2,university_of_texas_arlington,reject,64
296,154,142,92.0,2.62,27,2,university_of_texas_arlington,reject,64
303,155,148,94.0,2.93,15,0,university_of_texas_arlington,reject,64
300,159,141,82.0,2.47,36,0,university_of_texas_arlington,reject,64
295,158,137,78,2.55,0,0,university_of_texas_arlington,reject,64
308,156,152,105.0,1.95,10,0,university_of_texas_arlington,reject,64
309,160,149,101,3.4,3,0,university_of_texas_arlington,reject,64
301,157,144,86.0,2.86,0,0,university_of_texas_arlington,reject,64
300,158,142,80.0,2.0,0,3,university_of_texas_arlington,reject,64
295,154,141,91.0,2.45,15,0,university_of_texas_arlington,reject,64
299,158,141,86.0,1.85,30,0,university_of_texas_arlington,reject,64
309,162,147,108.0,2.8,45,0,university_of_texas_arlington,reject,64
303,160,143,82.0,2.24,2,0,university_of_texas_arlington,reject,64
298,158,140,85.0,1.82,18,0,university_of_texas_arlington,reject,64
299,153,146,97.0,2.96,24,3,university_of_texas_arlington,reject,64
306,162,144,110.0,3.37,24,0,university_of_texas_arlington,reject,64
302,158,144,101,3.18,30,0,university_of_texas_arlington,reject,64
294,154,140,85.0,2.84,0,0,university_of_texas_arlington,reject,64
319,162,157,109.0,1.86,0,3,university_of_texas_arlington,reject,64
305,161,144,97.0,3.23,0,0,university_of_texas_arlington,reject,64
315,163,152,105.0,2.76,10,0,university_of_texas_arlington,reject,64
298,155,143,93.0,2.1,36,0,university_of_texas_arlington,reject,64
300,156,144,87.0,2.6,18,0,university_of_texas_arlington,reject,64
303,156,147,95.0,3.02,26,0,university_of_texas_arlington,reject,64
307,158,149,103.0,2.0,27,0,university_of_texas_arlington,reject,64
302,158,144,82.0,3.46,20,3,university_of_texas_arlington,reject,64
302,153,149,95.0,2.2,36,3,university_of_texas_arlington,reject,64
296,148,148,86.0,2.55,30,0,university_of_texas_arlington,reject,64
297,158,139,78,2.7,0,0,university_of_texas_arlington,reject,64
294,158,136,87.0,2.05,0,0,university_of_texas_arlington,reject,64
307,160,147,101.0,2.35,0,0,university_of_texas_arlington,reject,64
321,164,157,110.0,3.0,20,0,university_of_texas_arlington,reject,64
321,164,157,110.0,3.0,20,0,university_of_texas_arlington,reject,64
304,159,145,81.0,2.8,30,0,university_of_texas_arlington,reject,64
311,170,141,89.0,2.77,10,0,university_of_texas_arlington,reject,64
315,163,152,98.0,3.6,1,0,university_of_texas_austin,accept,16
315,163,152,98.0,3.6,1,0,university_of_texas_austin,accept,16
325,170,155,114.0,3.88,30,0,university_of_texas_austin,accept,16
324,168,156,114.0,3.69,12,3,university_of_texas_austin,accept,16
329,170,159,112.0,3.6,4,3,university_of_texas_austin,accept,16
316,156,160,113.0,2.0,0,0,university_of_texas_austin,accept,16
315,167,148,104.0,3.86,16,3,university_of_texas_austin,accept,16
317,165,152,102.0,3.76,12,3,university_of_texas_austin,accept,16
324,167,157,110.0,3.37,15,0,university_of_texas_austin,accept,16
324,168,156,100.0,3.3,9,2,university_of_texas_austin,accept,16
332,170,162,116.0,3.65,20,3,university_of_texas_austin,accept,16
316,168,148,105.0,3.63,40,3,university_of_texas_austin,accept,16
322,170,152,113.0,3.66,6,3,university_of_texas_austin,accept,16
329,164,165,119.0,3.22,24,0,university_of_texas_austin,reject,16
329,164,165,119.0,3.22,24,0,university_of_texas_austin,reject,16
320,170,150,113.0,3.26,2,3,university_of_texas_austin,reject,16
314,162,152,104.0,2.52,34,0,university_of_texas_austin,reject,16
321,169,152,109.0,3.46,9,0,university_of_texas_austin,reject,16
324,167,157,108.0,3.12,6,2,university_of_texas_austin,reject,16
321,168,153,104.0,3.8,0,3,university_of_texas_austin,reject,16
320,166,154,107.0,3.8,12,0,university_of_texas_austin,reject,16
306,159,147,75.0,2.97,1,3,university_of_texas_austin,reject,16
315,164,151,93.0,2.95,18,0,university_of_texas_austin,reject,16
308,160,148,109.0,3.72,5,3,university_of_texas_austin,reject,16
320,165,155,107.0,3.6,24,0,university_of_texas_austin,reject,16
325,170,155,105.0,2.98,40,0,university_of_texas_austin,reject,16
314,166,148,75.0,3.1,0,0,university_of_texas_austin,reject,16
323,166,157,106.0,3.64,19,0,university_of_texas_austin,reject,16
326,165,161,103.0,2.53,0,3,university_of_texas_austin,reject,16
326,165,161,103.0,2.53,0,3,university_of_texas_austin,reject,16
321,170,151,111.0,3.63,17,0,university_of_texas_austin,reject,16
322,164,158,111.0,3.36,43,0,university_of_texas_austin,reject,16
323,170,153,112.0,3.67,4,0,university_of_texas_austin,reject,16
316,166,150,103.0,3.44,6,3,university_of_texas_austin,reject,16
316,163,153,111.0,3.64,14,0,university_of_texas_austin,reject,16
322,170,152,110.0,3.65,22,0,university_of_texas_austin,reject,16
320,168,152,99.0,3.48,37,0,university_of_texas_austin,reject,16
322,164,158,111.0,3.69,0,0,university_of_texas_austin,reject,16
324,169,155,109.0,3.33,21,3,university_of_texas_austin,reject,16
322,164,158,118.0,3.41,12,0,university_of_texas_austin,reject,16
323,162,161,109.0,3.49,19,0,university_of_texas_austin,reject,16
322,170,152,111.0,3.82,30,3,university_of_texas_austin,reject,16
321,170,151,108.0,3.2,6,0,university_of_texas_austin,reject,16
320,170,150,104.0,3.86,2,1,university_of_texas_austin,reject,16
326,165,161,107.0,3.18,12,0,university_of_texas_austin,reject,16
335,170,165,117.0,3.2,29,0,university_of_texas_austin,reject,16
317,168,149,110.0,3.54,8,3,university_of_texas_austin,reject,16
323,166,157,112.0,3.54,18,3,university_of_texas_austin,reject,16
323,168,155,117.0,3.82,5,0,university_of_texas_austin,reject,16
315,165,150,114.0,3.8,1,0,university_of_texas_austin,reject,16
319,170,149,105.0,3.36,22,3,university_of_texas_austin,reject,16
331,168,163,109.0,2.25,6,0,university_of_texas_austin,reject,16
318,170,148,101.0,4.0,12,0,university_of_texas_austin,reject,16
321,168,153,105.0,3.29,17,0,university_of_texas_austin,reject,16
324,170,154,106.0,3.44,10,0,university_of_texas_austin,reject,16
321,166,155,112.0,3.8,43,3,university_of_texas_austin,reject,16
326,169,157,85.0,3.54,3,1,university_of_texas_austin,reject,16
308,159,149,75.0,2.09,27,3,university_of_texas_austin,reject,16
323,168,155,100.0,3.46,29,3,university_of_texas_austin,reject,16
328,166,162,118.0,3.49,6,3,university_of_texas_austin,reject,16
325,166,159,110.0,3.74,22,0,university_of_texas_austin,reject,16
328,168,160,114.0,3.54,1,0,university_of_texas_austin,reject,16
325,168,157,111.0,3.75,16,0,university_of_texas_austin,reject,16
324,168,156,113.0,3.15,12,0,university_of_texas_austin,reject,16
327,169,158,110.0,3.2,3,0,university_of_texas_austin,reject,16
316,164,152,105.0,3.37,19,1,university_of_texas_austin,reject,16
313,165,148,102.0,2.86,41,0,university_of_texas_austin,reject,16
319,163,156,111.0,3.52,90,0,university_of_texas_austin,reject,16
319,165,154,101.0,3.65,32,0,university_of_texas_austin,reject,16
320,169,151,105.0,3.88,2,0,university_of_texas_austin,reject,16
311,159,152,114,3.28,0,0,university_of_texas_austin,reject,16
316,166,150,108.0,3.88,30,0,university_of_texas_austin,reject,16
323,166,157,111.0,3.9,23,0,university_of_texas_austin,reject,16
326,170,156,116.0,3.51,30,3,university_of_texas_austin,reject,16
311,168,143,91.0,2.83,6,0,university_of_texas_austin,reject,16
311,168,143,91.0,2.83,6,0,university_of_texas_austin,reject,16
315,166,149,95.0,3.52,0,0,university_of_texas_austin,reject,16
322,163,159,110.0,3.52,32,0,university_of_texas_austin,reject,16
331,167,164,112.0,3.44,5,0,university_of_texas_austin,reject,16
319,164,155,112.0,3.52,30,0,university_of_texas_austin,reject,16
321,165,156,102.0,2.55,12,0,university_of_texas_austin,reject,16
323,164,159,116.0,3.72,22,0,university_of_texas_austin,reject,16
332,170,162,113.0,3.61,24,0,university_of_texas_austin,reject,16
317,166,151,103.0,3.6,43,0,university_of_texas_austin,reject,16
326,168,158,110.0,2.92,60,0,university_of_texas_austin,reject,16
327,169,158,113.0,3.44,10,3,university_of_texas_austin,reject,16
321,169,152,107.0,3.7,27,0,university_of_texas_austin,reject,16
326,167,159,112.0,3.35,21,0,university_of_texas_austin,reject,16
318,169,149,105.0,3.65,7,0,university_of_texas_austin,reject,16
326,167,159,112.0,3.88,20,0,university_of_texas_austin,reject,16
335,169,166,116.0,3.8,7,3,university_of_texas_austin,reject,16
328,168,160,110.0,3.6,14,1,university_of_texas_austin,reject,16
328,168,160,110.0,3.6,14,1,university_of_texas_austin,reject,16
331,169,162,115.0,3.09,21,0,university_of_texas_austin,reject,16
320,161,159,113.0,2.7,82,0,university_of_texas_austin,reject,16
323,168,155,112.0,3.3,25,3,university_of_texas_austin,reject,16
319,170,149,86.0,3.68,13,0,university_of_texas_austin,reject,16
316,166,150,100.0,3.62,0,3,university_of_texas_austin,reject,16
330,168,162,119.0,3.76,32,0,university_of_texas_austin,reject,16
317,164,153,106.0,3.0,53,3,university_of_texas_austin,reject,16
320,163,157,111.0,3.46,0,0,university_of_texas_austin,reject,16
316,164,152,97.0,3.58,16,3,university_of_texas_austin,reject,16
320,166,154,110.0,3.16,7,3,university_of_texas_austin,reject,16
330,170,160,85.0,3.64,4,3,university_of_texas_austin,reject,16
322,168,154,114.0,3.82,23,0,university_of_texas_austin,reject,16
313,167,146,101.0,3.62,36,0,university_of_texas_austin,reject,16
325,165,160,107.0,3.64,0,0,university_of_texas_austin,reject,16
325,170,155,115.0,3.45,11,0,university_of_texas_austin,reject,16
325,170,155,115.0,3.45,11,0,university_of_texas_austin,reject,16
308,163,145,102.0,3.28,4,0,university_of_texas_austin,reject,16
309,159,150,93.0,3.58,44,0,university_of_texas_austin,reject,16
325,169,156,107.0,3.32,5,0,university_of_texas_austin,reject,16
333,170,163,110.0,3.46,36,0,university_of_texas_austin,reject,16
315,166,149,110.0,3.39,22,0,university_of_texas_austin,reject,16
315,166,149,110.0,3.39,22,0,university_of_texas_austin,reject,16
329,167,162,107.0,3.39,48,3,university_of_texas_austin,reject,16
321,165,156,106.0,3.46,16,3,university_of_texas_austin,reject,16
319,170,149,104.0,3.6,0,0,university_of_texas_austin,reject,16
318,162,156,107.0,3.61,2,0,university_of_texas_austin,reject,16
312,161,151,102.0,3.89,44,3,university_of_texas_austin,reject,16
325,170,155,106.0,3.71,2,0,university_of_texas_austin,reject,16
324,166,158,109.0,3.26,29,3,university_of_texas_austin,reject,16
325,170,155,110.0,3.44,33,0,university_of_texas_austin,reject,16
320,167,153,107.0,3.5,0,3,university_of_texas_austin,reject,16
340,170,170,116.0,3.46,2,2,university_of_texas_austin,reject,16
327,166,161,113.0,3.29,17,0,university_of_texas_austin,reject,16
310,163,147,98.0,2.25,46,3,university_of_texas_austin,reject,16
318,165,153,108.0,3.84,9,3,university_of_texas_austin,reject,16
334,167,167,119.0,3.5,50,0,university_of_texas_austin,reject,16
321,166,155,106.0,3.56,5,0,university_of_texas_austin,reject,16
314,161,153,100.0,3.16,0,0,university_of_texas_austin,reject,16
320,166,154,109.0,3.92,8,3,university_of_texas_austin,reject,16
321,166,155,107.0,3.32,36,0,university_of_texas_austin,reject,16
323,165,158,75.0,3.55,0,0,university_of_texas_austin,reject,16
322,168,154,117.0,3.94,4,0,university_of_texas_austin,reject,16
327,170,157,118.0,3.1,11,0,university_of_texas_austin,reject,16
328,169,159,113.0,3.75,22,3,university_of_texas_austin,reject,16
323,167,156,110.0,3.4,41,0,university_of_texas_austin,reject,16
321,169,152,103.0,2.54,40,0,university_of_texas_austin,reject,16
324,170,154,87.0,3.42,4,0,university_of_texas_austin,reject,16
326,166,160,117.0,2.8,6,0,university_of_texas_austin,reject,16
322,167,155,105.0,3.42,0,0,university_of_texas_austin,reject,16
322,167,155,105.0,3.42,0,0,university_of_texas_austin,reject,16
318,170,148,101.0,3.25,7,0,university_of_texas_austin,reject,16
319,166,153,100.0,2.67,30,3,university_of_texas_austin,reject,16
328,170,158,110.0,3.39,6,0,university_of_texas_austin,reject,16
309,163,146,101,3.36,0,0,university_of_texas_austin,reject,16
330,169,161,106.0,3.4,7,0,university_of_texas_austin,reject,16
330,170,160,114.0,3.04,6,3,university_of_texas_austin,reject,16
338,168,170,119.0,3.68,6,0,university_of_texas_austin,reject,16
326,170,156,108.0,3.59,26,0,university_of_texas_austin,reject,16
322,160,162,105.0,3.6,0,2,university_of_texas_austin,reject,16
319,164,155,115.0,1.43,0,0,university_of_texas_austin,reject,16
319,164,155,115.0,1.43,0,0,university_of_texas_austin,reject,16
303,158,145,101.0,3.33,33,0,university_of_texas_austin,reject,16
323,168,155,108.0,3.6,33,0,university_of_texas_austin,reject,16
312,162,150,110.0,3.44,19,0,university_of_texas_austin,reject,16
310,160,150,0,2.44,8,2,university_of_texas_austin,reject,16
324,169,155,116.0,3.42,26,3,university_of_texas_austin,reject,16
328,166,162,106.0,3.32,17,0,university_of_texas_austin,reject,16
327,170,157,0,2.55,37,0,university_of_texas_austin,reject,16
323,166,157,114.0,3.64,20,3,university_of_texas_austin,reject,16
322,168,154,107.0,3.22,29,0,university_of_texas_austin,reject,16
325,168,157,103.0,3.25,32,0,university_of_texas_austin,reject,16
331,168,163,116.0,3.94,30,0,university_of_texas_austin,reject,16
328,168,160,113.0,3.7,4,0,university_of_texas_austin,reject,16
318,165,153,101.0,3.74,16,3,university_of_texas_austin,reject,16
316,169,147,107.0,2.84,40,0,university_of_texas_austin,reject,16
326,169,157,0,3.6,17,0,university_of_texas_austin,reject,16
326,169,157,0,3.6,17,0,university_of_texas_austin,reject,16
320,167,153,100.0,3.82,36,0,university_of_texas_austin,reject,16
327,169,158,109.0,3.46,40,0,university_of_texas_austin,reject,16
322,170,152,104.0,3.32,39,0,university_of_texas_austin,reject,16
310,161,149,95.0,3.74,28,0,university_of_texas_austin,reject,16
325,170,155,118.0,2.99,17,0,university_of_texas_austin,reject,16
324,166,158,114.0,3.76,13,3,university_of_texas_austin,reject,16
330,170,160,0,3.93,34,3,university_of_texas_austin,reject,16
317,162,155,108.0,2.74,6,0,university_of_texas_austin,reject,16
321,165,156,105.0,3.0,39,0,university_of_texas_austin,reject,16
327,168,159,115.0,2.8,15,0,university_of_texas_austin,reject,16
324,168,156,113.0,3.64,0,0,university_of_texas_austin,reject,16
328,163,165,114.0,2.99,69,0,university_of_texas_austin,reject,16
330,166,164,117.0,3.58,9,3,university_of_texas_austin,reject,16
311,162,149,103.0,3.36,21,3,university_of_texas_austin,reject,16
324,165,159,108.0,3.42,0,0,university_of_texas_austin,reject,16
324,165,159,108.0,3.42,0,0,university_of_texas_austin,reject,16
326,169,157,110.0,1.41,0,3,university_of_texas_austin,reject,16
314,167,147,0,3.37,29,0,university_of_texas_austin,reject,16
302,158,144,81.0,3.52,18,0,university_of_texas_austin,reject,16
322,153,169,105.0,3.16,12,0,university_of_texas_austin,reject,16
307,166,141,101,3.62,22,3,university_of_texas_austin,reject,16
312,164,148,97.0,3.65,27,3,university_of_texas_austin,reject,16
311,162,149,104.0,2.45,0,0,university_of_texas_austin,reject,16
323,168,155,104.0,3.64,20,3,university_of_texas_austin,reject,16
317,163,154,106.0,3.42,34,3,university_of_texas_austin,reject,16
316,165,151,112.0,3.09,1,1,university_of_texas_austin,reject,16
324,170,154,112.0,3.32,4,3,university_of_texas_austin,reject,16
318,162,156,102.0,3.76,11,3,university_of_texas_austin,reject,16
325,167,158,103.0,3.44,15,0,university_of_texas_austin,reject,16
319,167,152,98.0,3.59,9,0,university_of_texas_austin,reject,16
316,162,154,106.0,3.52,16,0,university_of_texas_austin,reject,16
322,168,154,113.0,3.74,30,0,university_of_texas_austin,reject,16
335,170,165,109.0,3.42,42,0,university_of_texas_austin,reject,16
317,162,155,113.0,3.75,1,3,university_of_texas_austin,reject,16
329,166,163,107.0,3.47,15,3,university_of_texas_austin,reject,16
325,167,158,110.0,3.85,5,3,university_of_texas_austin,reject,16
317,163,154,111.0,3.66,38,0,university_of_texas_austin,reject,16
322,170,152,0,3.02,31,0,university_of_texas_austin,reject,16
313,164,149,99.0,3.38,29,0,university_of_texas_austin,reject,16
325,168,157,116.0,3.72,23,3,university_of_texas_austin,reject,16
326,156,170,111.0,3.0,21,0,university_of_texas_austin,reject,16
332,169,163,113.0,3.54,31,0,university_of_texas_austin,reject,16
324,169,155,113.0,3.36,16,0,university_of_texas_austin,reject,16
328,168,160,110.0,3.62,1,0,university_of_texas_austin,reject,16
329,170,159,114.0,3.05,17,1,university_of_texas_austin,reject,16
314,166,148,100.0,3.66,11,3,university_of_texas_austin,reject,16
330,170,160,0,3.73,2,0,university_of_texas_austin,reject,16
327,170,157,108.0,3.32,12,0,university_of_texas_austin,reject,16
316,162,154,110.0,3.82,16,3,university_of_texas_austin,reject,16
331,170,161,0,3.62,21,3,university_of_texas_austin,reject,16
314,168,146,106.0,3.74,19,3,university_of_texas_austin,reject,16
319,166,153,97.0,3.42,21,0,university_of_texas_austin,reject,16
325,168,157,115.0,3.31,33,3,university_of_texas_austin,reject,16
318,164,154,0,3.36,24,3,university_of_texas_austin,reject,16
320,164,156,118.0,3.77,2,0,university_of_texas_austin,reject,16
326,170,156,114.0,3.76,4,0,university_of_texas_austin,reject,16
324,167,157,107.0,3.71,1,0,university_of_texas_austin,reject,16
315,166,149,0,3.08,4,0,university_of_texas_austin,reject,16
325,167,158,109.0,3.6,4,0,university_of_texas_austin,reject,16
316,162,154,110.0,3.81,16,3,university_of_texas_austin,reject,16
318,160,158,106.0,3.59,0,0,university_of_texas_austin,reject,16
325,170,155,114.0,3.09,25,3,university_of_texas_austin,reject,16
333,170,163,114.0,3.28,22,3,university_of_texas_austin,reject,16
324,165,159,113.0,3.4,0,0,university_of_texas_dallas,accept,52
324,165,159,113.0,3.4,0,0,university_of_texas_dallas,accept,52
315,162,153,104.0,3.8,37,3,university_of_texas_dallas,accept,52
333,170,163,110.0,3.46,36,0,university_of_texas_dallas,accept,52
313,161,152,103.0,3.38,0,0,university_of_texas_dallas,accept,52
320,163,157,113.0,3.77,0,2,university_of_texas_dallas,accept,52
310,163,147,101,3.56,16,3,university_of_texas_dallas,accept,52
314,165,149,93.0,2.99,18,0,university_of_texas_dallas,accept,52
317,168,149,75.0,3.23,6,1,university_of_texas_dallas,accept,52
312,164,148,105.0,3.48,45,0,university_of_texas_dallas,accept,52
317,159,158,114.0,3.52,4,1,university_of_texas_dallas,accept,52
317,167,150,101,3.47,32,0,university_of_texas_dallas,accept,52
311,167,144,87.0,3.36,0,0,university_of_texas_dallas,accept,52
311,163,148,101,3.4,10,0,university_of_texas_dallas,accept,52
310,160,150,89.0,2.56,26,0,university_of_texas_dallas,accept,52
312,160,152,102.0,3.3,17,0,university_of_texas_dallas,accept,52
317,164,153,96.0,2.7,32,0,university_of_texas_dallas,accept,52
313,163,150,101,3.0,3,3,university_of_texas_dallas,accept,52
312,163,149,107.0,3.46,16,3,university_of_texas_dallas,accept,52
319,167,152,104.0,3.13,34,0,university_of_texas_dallas,accept,52
319,167,152,104.0,3.13,34,0,university_of_texas_dallas,accept,52
308,159,149,96.0,3.54,18,3,university_of_texas_dallas,accept,52
307,163,144,91.0,3.5,17,0,university_of_texas_dallas,accept,52
323,168,155,110.0,3.28,26,0,university_of_texas_dallas,accept,52
317,165,152,110.0,3.87,16,3,university_of_texas_dallas,accept,52
314,164,150,75.0,3.25,11,3,university_of_texas_dallas,accept,52
305,146,159,86.0,3.75,14,3,university_of_texas_dallas,accept,52
312,161,151,88.0,3.29,35,2,university_of_texas_dallas,accept,52
311,163,148,105.0,1.25,0,0,university_of_texas_dallas,accept,52
321,167,154,107.0,3.37,14,0,university_of_texas_dallas,accept,52
312,157,155,94.0,3.34,12,2,university_of_texas_dallas,accept,52
312,164,148,101,3.0,30,0,university_of_texas_dallas,accept,52
315,169,146,101,3.28,0,0,university_of_texas_dallas,accept,52
309,163,146,97.0,3.08,36,0,university_of_texas_dallas,accept,52
316,165,151,108.0,3.56,0,0,university_of_texas_dallas,accept,52
317,167,150,105.0,3.56,41,0,university_of_texas_dallas,accept,52
308,159,149,95.0,3.36,14,0,university_of_texas_dallas,accept,52
308,159,149,95.0,3.36,14,0,university_of_texas_dallas,accept,52
306,157,149,111.0,3.55,0,0,university_of_texas_dallas,accept,52
308,154,154,114,3.53,1,0,university_of_texas_dallas,accept,52
314,162,152,96.0,3.08,27,0,university_of_texas_dallas,accept,52
315,162,153,100.0,2.92,28,3,university_of_texas_dallas,accept,52
312,169,143,86.0,3.23,3,0,university_of_texas_dallas,accept,52
308,162,146,97.0,2.86,4,0,university_of_texas_dallas,accept,52
309,164,145,94.0,3.82,35,0,university_of_texas_dallas,accept,52
316,160,156,114,2.97,0,0,university_of_texas_dallas,accept,52
317,162,155,101.0,3.46,48,0,university_of_texas_dallas,accept,52
310,157,153,114,3.54,0,0,university_of_texas_dallas,accept,52
317,162,155,101.0,3.46,48,0,university_of_texas_dallas,accept,52
310,157,153,114,3.54,0,0,university_of_texas_dallas,accept,52
321,170,151,101,3.63,21,0,university_of_texas_dallas,accept,52
320,166,154,103.0,3.0,12,3,university_of_texas_dallas,accept,52
325,169,156,111.0,3.43,2,0,university_of_texas_dallas,accept,52
305,161,144,65.0,2.6,37,0,university_of_texas_dallas,accept,52
320,164,156,110.0,3.2,0,0,university_of_texas_dallas,accept,52
314,168,146,103.0,3.26,24,0,university_of_texas_dallas,accept,52
333,166,167,116.0,3.05,18,0,university_of_texas_dallas,accept,52
333,166,167,116.0,3.05,18,0,university_of_texas_dallas,accept,52
310,161,149,107.0,2.99,24,0,university_of_texas_dallas,accept,52
311,164,147,89.0,3.65,2,0,university_of_texas_dallas,accept,52
321,165,156,106.0,3.46,16,3,university_of_texas_dallas,accept,52
312,167,145,75.0,3.36,0,0,university_of_texas_dallas,accept,52
313,163,150,106.0,3.53,0,0,university_of_texas_dallas,accept,52
312,161,151,102.0,3.27,27,0,university_of_texas_dallas,accept,52
316,160,156,106.0,3.25,34,0,university_of_texas_dallas,accept,52
309,158,151,111.0,3.36,0,0,university_of_texas_dallas,accept,52
314,168,146,75.0,3.35,12,1,university_of_texas_dallas,accept,52
312,165,147,104.0,3.56,54,0,university_of_texas_dallas,accept,52
319,165,154,104.0,3.66,15,0,university_of_texas_dallas,accept,52
310,160,150,93.0,3.6,1,0,university_of_texas_dallas,accept,52
323,168,155,116.0,3.44,20,0,university_of_texas_dallas,accept,52
311,167,144,107.0,3.47,8,3,university_of_texas_dallas,accept,52
320,166,154,107.0,2.5,0,3,university_of_texas_dallas,accept,52
318,167,151,111.0,3.57,0,0,university_of_texas_dallas,accept,52
318,167,151,111.0,3.57,0,0,university_of_texas_dallas,accept,52
313,160,153,96.0,3.4,3,0,university_of_texas_dallas,accept,52
315,167,148,101,3.48,15,0,university_of_texas_dallas,accept,52
315,165,150,105.0,3.64,8,0,university_of_texas_dallas,accept,52
307,157,150,119.0,3.21,82,0,university_of_texas_dallas,accept,52
319,170,149,100.0,2.75,11,3,university_of_texas_dallas,accept,52
327,167,160,110.0,2.72,64,0,university_of_texas_dallas,accept,52
312,165,147,101.0,3.36,4,0,university_of_texas_dallas,accept,52
308,158,150,90.0,3.61,12,0,university_of_texas_dallas,accept,52
309,160,149,104.0,3.66,33,1,university_of_texas_dallas,accept,52
310,162,148,107.0,3.71,20,0,university_of_texas_dallas,accept,52
314,162,152,108.0,3.53,0,0,university_of_texas_dallas,accept,52
306,158,148,110.0,3.49,28,0,university_of_texas_dallas,accept,52
307,157,150,114,3.5,9,0,university_of_texas_dallas,accept,52
318,160,158,107.0,3.56,0,0,university_of_texas_dallas,accept,52
316,164,152,108.0,3.23,30,3,university_of_texas_dallas,accept,52
315,159,156,102.0,3.37,27,0,university_of_texas_dallas,accept,52
321,166,155,101.0,3.52,0,0,university_of_texas_dallas,accept,52
321,164,157,112.0,3.42,4,0,university_of_texas_dallas,accept,52
315,160,155,106.0,3.76,4,0,university_of_texas_dallas,accept,52
314,164,150,109.0,3.38,17,0,university_of_texas_dallas,accept,52
314,164,150,109.0,3.38,17,0,university_of_texas_dallas,accept,52
322,167,155,113.0,3.76,16,3,university_of_texas_dallas,accept,52
311,161,150,101,2.85,0,0,university_of_texas_dallas,accept,52
308,162,146,101,3.0,19,1,university_of_texas_dallas,accept,52
312,167,145,103.0,3.4,60,0,university_of_texas_dallas,accept,52
306,157,149,94.0,3.58,28,0,university_of_texas_dallas,accept,52
317,160,157,109.0,3.01,24,3,university_of_texas_dallas,accept,52
310,159,151,111.0,3.86,13,0,university_of_texas_dallas,accept,52
311,160,151,97.0,3.37,21,0,university_of_texas_dallas,accept,52
317,167,150,104.0,3.28,2,0,university_of_texas_dallas,accept,52
327,167,160,115.0,3.56,2,0,university_of_texas_dallas,accept,52
317,163,154,112.0,3.4,11,3,university_of_texas_dallas,accept,52
310,157,153,96.0,3.4,4,0,university_of_texas_dallas,accept,52
311,168,143,101,3.06,0,0,university_of_texas_dallas,accept,52
316,164,152,108.0,3.84,0,1,university_of_texas_dallas,accept,52
317,163,154,107.0,3.64,41,0,university_of_texas_dallas,accept,52
322,167,155,109.0,3.26,1,1,university_of_texas_dallas,accept,52
325,169,156,100.0,3.56,0,0,university_of_texas_dallas,accept,52
315,164,151,103.0,3.62,1,0,university_of_texas_dallas,accept,52
322,166,156,107.0,3.48,26,0,university_of_texas_dallas,accept,52
322,166,156,107.0,3.48,26,0,university_of_texas_dallas,accept,52
316,167,149,103.0,3.45,19,0,university_of_texas_dallas,accept,52
327,168,159,115.0,3.02,18,0,university_of_texas_dallas,accept,52
321,166,155,111.0,3.24,9,0,university_of_texas_dallas,accept,52
324,170,154,115.0,3.63,12,0,university_of_texas_dallas,accept,52
311,164,147,92.0,3.68,0,3,university_of_texas_dallas,accept,52
310,161,149,102.0,3.66,20,3,university_of_texas_dallas,accept,52
321,164,157,105.0,3.7,18,3,university_of_texas_dallas,accept,52
310,163,147,102.0,3.64,21,0,university_of_texas_dallas,accept,52
310,158,152,104.0,3.6,0,0,university_of_texas_dallas,accept,52
309,163,146,102.0,3.1,33,0,university_of_texas_dallas,accept,52
309,159,150,107.0,3.23,20,0,university_of_texas_dallas,accept,52
313,165,148,102.0,2.64,30,3,university_of_texas_dallas,accept,52
316,152,164,93.0,3.56,45,3,university_of_texas_dallas,accept,52
315,165,150,98.0,3.76,6,3,university_of_texas_dallas,accept,52
322,166,156,112.0,3.26,4,0,university_of_texas_dallas,accept,52
312,167,145,75.0,3.62,0,0,university_of_texas_dallas,accept,52
318,163,155,114,3.22,21,0,university_of_texas_dallas,accept,52
324,169,155,115.0,3.33,19,0,university_of_texas_dallas,accept,52
315,169,146,92.0,3.68,7,0,university_of_texas_dallas,accept,52
315,169,146,92.0,3.68,7,0,university_of_texas_dallas,accept,52
313,157,156,109.0,3.35,68,0,university_of_texas_dallas,accept,52
310,156,154,103.0,3.17,18,0,university_of_texas_dallas,accept,52
308,163,145,93.0,3.75,0,0,university_of_texas_dallas,accept,52
325,164,161,111.0,3.32,18,2,university_of_texas_dallas,accept,52
311,159,152,114,3.28,0,0,university_of_texas_dallas,accept,52
312,161,151,104.0,3.24,0,0,university_of_texas_dallas,accept,52
310,154,156,112.0,3.61,3,0,university_of_texas_dallas,accept,52
327,167,160,75.0,3.23,0,0,university_of_texas_dallas,accept,52
315,158,157,100.0,3.0,0,0,university_of_texas_dallas,accept,52
312,159,153,103.0,3.16,4,0,university_of_texas_dallas,accept,52
322,167,155,105.0,3.22,19,0,university_of_texas_dallas,accept,52
303,153,150,101,3.62,3,0,university_of_texas_dallas,accept,52
315,164,151,109.0,3.28,1,0,university_of_texas_dallas,accept,52
313,162,151,92.0,3.31,1,3,university_of_texas_dallas,accept,52
324,169,155,107.0,3.27,20,0,university_of_texas_dallas,accept,52
316,162,154,100.0,3.46,0,0,university_of_texas_dallas,accept,52
311,159,152,105.0,3.13,0,0,university_of_texas_dallas,accept,52
315,160,155,111.0,3.34,5,0,university_of_texas_dallas,accept,52
314,163,151,114,3.24,2,3,university_of_texas_dallas,accept,52
314,163,151,114,3.24,2,3,university_of_texas_dallas,accept,52
320,168,152,99.0,3.48,37,0,university_of_texas_dallas,accept,52
309,159,150,94.0,3.25,0,0,university_of_texas_dallas,accept,52
324,169,155,104.0,2.89,43,0,university_of_texas_dallas,accept,52
320,161,159,114,3.19,0,0,university_of_texas_dallas,accept,52
321,168,153,109.0,3.27,2,0,university_of_texas_dallas,accept,52
316,164,152,108.0,3.47,11,0,university_of_texas_dallas,accept,52
313,161,152,75.0,3.49,19,2,university_of_texas_dallas,accept,52
323,167,156,75.0,3.55,1,3,university_of_texas_dallas,accept,52
314,164,150,99.0,3.4,0,0,university_of_texas_dallas,accept,52
320,165,155,108.0,3.46,5,3,university_of_texas_dallas,accept,52
321,168,153,97.0,3.12,3,0,university_of_texas_dallas,accept,52
317,162,155,111.0,2.92,14,3,university_of_texas_dallas,accept,52
308,162,146,95.0,3.44,31,0,university_of_texas_dallas,accept,52
315,162,153,0,3.76,3,0,university_of_texas_dallas,accept,52
327,169,158,107.0,3.45,31,0,university_of_texas_dallas,accept,52
333,168,165,115.0,3.16,2,0,university_of_texas_dallas,accept,52
333,168,165,115.0,3.16,2,0,university_of_texas_dallas,accept,52
310,162,148,96.0,3.47,1,3,university_of_texas_dallas,accept,52
326,165,161,107.0,3.18,12,0,university_of_texas_dallas,accept,52
316,168,148,101,3.44,17,0,university_of_texas_dallas,accept,52
306,158,148,75.0,3.6,17,0,university_of_texas_dallas,accept,52
324,168,156,114.0,3.26,44,3,university_of_texas_dallas,accept,52
332,168,164,115.0,3.44,18,0,university_of_texas_dallas,accept,52
324,163,161,108.0,3.53,1,0,university_of_texas_dallas,accept,52
314,169,145,99.0,3.26,12,0,university_of_texas_dallas,accept,52
306,158,148,114,3.45,14,0,university_of_texas_dallas,accept,52
319,166,153,109.0,3.19,27,0,university_of_texas_dallas,accept,52
308,166,142,100.0,2.98,39,0,university_of_texas_dallas,accept,52
310,161,149,96.0,3.56,0,0,university_of_texas_dallas,accept,52
308,158,150,112.0,3.55,0,0,university_of_texas_dallas,accept,52
324,163,161,115.0,3.58,9,1,university_of_texas_dallas,accept,52
324,164,160,108.0,3.38,20,3,university_of_texas_dallas,accept,52
316,164,152,75.0,3.15,17,0,university_of_texas_dallas,accept,52
326,170,156,120.0,3.07,20,3,university_of_texas_dallas,accept,52
319,167,152,114.0,3.63,6,0,university_of_texas_dallas,accept,52
319,167,152,114.0,3.63,6,0,university_of_texas_dallas,accept,52
311,165,146,101,3.82,0,0,university_of_texas_dallas,accept,52
319,168,151,109.0,3.34,12,0,university_of_texas_dallas,accept,52
313,161,152,101,3.66,0,0,university_of_texas_dallas,accept,52
320,162,158,100.0,2.93,32,0,university_of_texas_dallas,accept,52
317,165,152,105.0,2.95,16,0,university_of_texas_dallas,accept,52
312,163,149,100.0,4.0,79,3,university_of_texas_dallas,accept,52
307,160,147,100.0,3.76,7,1,university_of_texas_dallas,accept,52
308,166,142,91.0,3.44,8,0,university_of_texas_dallas,accept,52
317,165,152,114,3.25,2,0,university_of_texas_dallas,accept,52
308,163,145,97.0,3.8,5,0,university_of_texas_dallas,accept,52
321,167,154,102.0,3.44,24,0,university_of_texas_dallas,accept,52
322,168,154,114,2.94,0,0,university_of_texas_dallas,accept,52
317,163,154,107.0,3.47,30,3,university_of_texas_dallas,accept,52
320,163,157,110.0,3.4,0,0,university_of_texas_dallas,accept,52
318,161,157,103.0,3.48,0,3,university_of_texas_dallas,accept,52
324,166,158,109.0,3.26,29,3,university_of_texas_dallas,accept,52
307,165,142,90.0,3.74,15,3,university_of_texas_dallas,accept,52
307,165,142,90.0,3.74,15,3,university_of_texas_dallas,accept,52
315,164,151,109.0,3.38,25,0,university_of_texas_dallas,accept,52
314,161,153,102.0,3.46,16,0,university_of_texas_dallas,accept,52
313,157,156,107.0,3.44,4,3,university_of_texas_dallas,accept,52
317,166,151,103.0,2.96,12,3,university_of_texas_dallas,accept,52
321,167,154,0,3.6,6,0,university_of_texas_dallas,accept,52
324,164,160,108.0,3.34,26,0,university_of_texas_dallas,accept,52
325,168,157,114.0,2.96,27,0,university_of_texas_dallas,accept,52
309,161,148,65.0,3.25,20,0,university_of_texas_dallas,accept,52
319,163,156,113.0,3.44,10,0,university_of_texas_dallas,accept,52
320,170,150,113.0,3.26,2,3,university_of_texas_dallas,accept,52
314,166,148,89.0,2.67,13,2,university_of_texas_dallas,accept,52
315,166,149,95.0,3.52,0,0,university_of_texas_dallas,accept,52
308,162,146,94.0,3.2,20,0,university_of_texas_dallas,accept,52
310,158,152,75.0,3.4,6,3,university_of_texas_dallas,accept,52
322,168,154,101.0,3.11,27,0,university_of_texas_dallas,accept,52
312,160,152,105.0,3.6,20,0,university_of_texas_dallas,accept,52
310,161,149,100.0,3.74,8,0,university_of_texas_dallas,accept,52
313,165,148,97.0,3.28,0,3,university_of_texas_dallas,accept,52
312,165,147,101,3.11,0,0,university_of_texas_dallas,accept,52
312,160,152,75.0,3.07,18,0,university_of_texas_dallas,reject,52
312,160,152,75.0,3.07,18,0,university_of_texas_dallas,reject,52
307,161,146,105.0,2.5,31,3,university_of_texas_dallas,reject,52
305,162,143,100.0,2.6,16,0,university_of_texas_dallas,reject,52
316,159,157,104.0,1.89,43,0,university_of_texas_dallas,reject,52
298,160,138,91.0,3.24,31,0,university_of_texas_dallas,reject,52
311,161,150,100.0,3.06,6,2,university_of_texas_dallas,reject,52
300,158,142,84.0,2.6,10,2,university_of_texas_dallas,reject,52
316,161,155,109.0,2.68,32,2,university_of_texas_dallas,reject,52
314,162,152,104.0,2.52,34,0,university_of_texas_dallas,reject,52
320,168,152,110.0,3.14,3,0,university_of_texas_dallas,reject,52
320,168,152,108.0,2.91,12,0,university_of_texas_dallas,reject,52
311,164,147,97.0,2.91,40,0,university_of_texas_dallas,reject,52
309,165,144,75.0,3.02,17,0,university_of_texas_dallas,reject,52
316,164,152,99.0,2.64,8,3,university_of_texas_dallas,reject,52
314,168,146,101,2.65,12,0,university_of_texas_dallas,reject,52
310,158,152,103.0,2.6,25,0,university_of_texas_dallas,reject,52
301,158,143,101,3.27,6,0,university_of_texas_dallas,reject,52
299,149,150,94.0,2.46,5,3,university_of_texas_dallas,reject,52
305,156,149,95.0,3.16,29,2,university_of_texas_dallas,reject,52
319,163,156,114,2.85,0,0,university_of_texas_dallas,reject,52
312,169,143,101,2.49,30,0,university_of_texas_dallas,reject,52
312,169,143,101,2.49,30,0,university_of_texas_dallas,reject,52
320,167,153,108.0,2.5,36,0,university_of_texas_dallas,reject,52
312,160,152,90.0,2.7,0,3,university_of_texas_dallas,reject,52
313,163,150,101,3.0,18,0,university_of_texas_dallas,reject,52
304,154,150,92.0,3.2,1,0,university_of_texas_dallas,reject,52
315,164,151,93.0,2.95,18,0,university_of_texas_dallas,reject,52
300,153,147,101,1.9,39,1,university_of_texas_dallas,reject,52
323,170,153,100.0,3.02,1,3,university_of_texas_dallas,reject,52
315,160,155,105.0,3.17,9,0,university_of_texas_dallas,reject,52
296,156,140,82.0,3.08,6,0,university_of_texas_dallas,reject,52
306,157,149,100.0,3.56,20,0,university_of_texas_dallas,reject,52
322,163,159,108.0,2.71,29,0,university_of_texas_dallas,reject,52
302,162,140,101,3.52,22,0,university_of_texas_dallas,reject,52
325,166,159,109.0,2.75,42,0,university_of_texas_dallas,reject,52
306,155,151,75.0,3.19,20,0,university_of_texas_dallas,reject,52
302,158,144,65.0,2.24,22,0,university_of_texas_dallas,reject,52
304,160,144,92.0,2.75,3,0,university_of_texas_dallas,reject,52
301,156,145,75.0,3.43,0,0,university_of_texas_dallas,reject,52
306,159,147,96.0,3.18,2,0,university_of_texas_dallas,reject,52
304,161,143,101,3.12,11,0,university_of_texas_dallas,reject,52
304,161,143,101,3.12,11,0,university_of_texas_dallas,reject,52
317,164,153,103.0,2.28,21,0,university_of_texas_dallas,reject,52
305,159,146,98.0,2.7,3,2,university_of_texas_dallas,reject,52
314,166,148,75.0,2.85,2,0,university_of_texas_dallas,reject,52
313,165,148,93.0,3.06,19,0,university_of_texas_dallas,reject,52
299,157,142,75.0,3.25,2,0,university_of_texas_dallas,reject,52
322,162,160,114.0,2.76,16,2,university_of_texas_dallas,reject,52
322,167,155,75.0,3.17,30,0,university_of_texas_dallas,reject,52
314,166,148,93.0,3.04,21,0,university_of_texas_dallas,reject,52
314,163,151,101,2.84,0,0,university_of_texas_dallas,reject,52
317,164,153,109.0,2.75,41,0,university_of_texas_dallas,reject,52
314,163,151,90.0,2.64,60,0,university_of_texas_dallas,reject,52
316,166,150,104.0,2.64,27,0,university_of_texas_dallas,reject,52
318,166,152,102.0,3.22,30,0,university_of_texas_dallas,reject,52
305,166,139,101,3.37,4,0,university_of_texas_dallas,reject,52
310,164,146,65.0,3.03,0,0,university_of_texas_dallas,reject,52
305,153,152,107.0,2.75,24,0,university_of_texas_dallas,reject,52
311,158,153,85.0,2.8,29,2,university_of_texas_dallas,reject,52
311,161,150,99.0,3.0,2,3,university_of_texas_dallas,reject,52
312,163,149,75.0,3.09,23,0,university_of_texas_dallas,reject,52
306,159,147,101.0,2.35,3,0,university_of_texas_dallas,reject,52
306,159,147,101.0,2.35,3,0,university_of_texas_dallas,reject,52
304,162,142,65.0,3.38,20,3,university_of_texas_dallas,reject,52
322,167,155,103.0,2.92,23,0,university_of_texas_dallas,reject,52
318,161,157,114.0,2.95,18,0,university_of_texas_dallas,reject,52
324,169,155,102.0,3.05,0,0,university_of_texas_dallas,reject,52
314,163,151,95.0,2.51,60,0,university_of_texas_dallas,reject,52
287,149,138,83.0,2.73,25,0,university_of_texas_dallas,reject,52
300,156,144,96.0,3.3,18,0,university_of_texas_dallas,reject,52
310,166,144,92.0,2.4,0,0,university_of_texas_dallas,reject,52
320,169,151,105.0,3.28,0,3,university_of_texas_dallas,reject,52
306,163,143,93.0,3.55,26,0,university_of_texas_dallas,reject,52
309,162,147,86.0,3.05,49,0,university_of_texas_dallas,reject,52
314,159,155,105.0,3.04,7,0,university_of_texas_dallas,reject,52
308,163,145,102.0,3.28,4,0,university_of_texas_dallas,reject,52
308,162,146,93.0,2.57,0,2,university_of_texas_dallas,reject,52
309,163,146,97.0,2.5,16,0,university_of_texas_dallas,reject,52
302,157,145,81.0,3.34,4,0,university_of_texas_dallas,reject,52
301,159,142,93.0,3.36,30,0,university_of_texas_dallas,reject,52
319,164,155,113.0,1.9,94,0,university_of_texas_dallas,reject,52
314,165,149,102.0,2.65,33,0,university_of_texas_dallas,reject,52
305,158,147,94.0,3.23,0,3,university_of_texas_dallas,reject,52
305,158,147,94.0,3.23,0,3,university_of_texas_dallas,reject,52
314,160,154,112.0,2.92,18,0,university_of_texas_dallas,reject,52
297,154,143,101,2.46,14,0,university_of_texas_dallas,reject,52
300,155,145,65.0,2.68,0,0,university_of_texas_dallas,reject,52
304,154,150,75.0,2.25,16,0,university_of_texas_dallas,reject,52
305,161,144,97.0,2.63,13,0,university_of_texas_dallas,reject,52
303,158,145,106.0,3.2,1,0,university_of_texas_dallas,reject,52
301,160,141,93.0,2.55,44,0,university_of_texas_dallas,reject,52
301,153,148,92.0,3.04,0,0,university_of_texas_dallas,reject,52
305,160,145,85.0,3.0,30,0,university_of_texas_dallas,reject,52
318,167,151,109.0,2.76,35,0,university_of_texas_dallas,reject,52
302,151,151,104.0,2.83,3,3,university_of_texas_dallas,reject,52
315,158,157,113.0,2.38,17,2,university_of_texas_dallas,reject,52
310,163,147,98.0,2.25,46,3,university_of_texas_dallas,reject,52
307,161,146,101,2.58,41,0,university_of_texas_dallas,reject,52
310,160,150,100.0,2.6,1,3,university_of_texas_dallas,reject,52
312,163,149,100.0,2.88,27,0,university_of_texas_dallas,reject,52
304,161,143,87.0,3.02,40,0,university_of_texas_dallas,reject,52
320,160,160,108.0,3.02,8,3,university_of_texas_dallas,reject,52
319,164,155,103.0,2.97,19,0,university_of_texas_dallas,reject,52
295,147,148,92.0,3.44,24,0,university_of_texas_dallas,reject,52
295,147,148,92.0,3.44,24,0,university_of_texas_dallas,reject,52
306,154,152,111.0,2.42,3,0,university_of_texas_dallas,reject,52
306,156,150,104.0,3.42,24,0,university_of_texas_dallas,reject,52
305,161,144,98.0,2.78,2,0,university_of_texas_dallas,reject,52
302,157,145,95.0,2.05,30,0,university_of_texas_dallas,reject,52
319,166,153,114,2.9,26,0,university_of_texas_dallas,reject,52
310,162,148,94.0,2.89,3,0,university_of_texas_dallas,reject,52
320,167,153,108.0,3.03,0,1,university_of_texas_dallas,reject,52
306,157,149,91.0,2.12,44,0,university_of_texas_dallas,reject,52
319,165,154,111.0,2.61,44,0,university_of_texas_dallas,reject,52
310,159,151,65.0,2.58,16,0,university_of_texas_dallas,reject,52
260,130,130,0,2.0,0,0,university_of_texas_dallas,reject,52
311,164,147,101,3.24,0,0,university_of_texas_dallas,reject,52
307,161,146,101,2.85,0,0,university_of_texas_dallas,reject,52
325,166,159,104.0,2.69,34,0,university_of_texas_dallas,reject,52
312,160,152,104.0,3.19,0,0,university_of_texas_dallas,reject,52
309,159,150,104.0,2.97,39,0,university_of_texas_dallas,reject,52
304,155,149,83.0,3.08,0,0,university_of_texas_dallas,reject,52
306,155,151,113.0,3.12,12,0,university_of_texas_dallas,reject,52
312,163,149,100.0,3.17,33,0,university_of_texas_dallas,reject,52
317,162,155,102.0,2.65,49,0,university_of_texas_dallas,reject,52
317,162,155,102.0,2.65,49,0,university_of_texas_dallas,reject,52
311,162,149,101.0,2.33,25,0,university_of_texas_dallas,reject,52
301,158,143,91.0,3.02,23,0,university_of_texas_dallas,reject,52
303,162,141,96.0,2.96,20,3,university_of_texas_dallas,reject,52
303,164,139,65.0,2.95,24,0,university_of_texas_dallas,reject,52
303,156,147,101,2.92,23,3,university_of_texas_dallas,reject,52
308,161,147,94.0,2.92,15,3,university_of_texas_dallas,reject,52
306,158,148,96.0,2.43,30,0,university_of_texas_dallas,reject,52
308,165,143,96.0,2.2,92,0,university_of_texas_dallas,reject,52
309,158,151,111.0,2.92,31,0,university_of_texas_dallas,reject,52
308,165,143,96.0,2.2,92,0,university_of_texas_dallas,reject,52
309,158,151,111.0,2.92,31,0,university_of_texas_dallas,reject,52
310,159,151,108.0,2.45,112,0,university_of_texas_dallas,reject,52
305,165,140,89.0,3.34,0,0,university_of_texas_dallas,reject,52
312,162,150,100.0,3.07,1,0,university_of_texas_dallas,reject,52
304,156,148,82.0,3.2,6,1,university_of_texas_dallas,reject,52
305,161,144,94.0,3.26,10,0,university_of_texas_dallas,reject,52
300,155,145,105.0,3.23,0,3,university_of_texas_dallas,reject,52
300,157,143,99.0,3.3,30,0,university_of_texas_dallas,reject,52
313,166,147,101,3.01,2,0,university_of_texas_dallas,reject,52
299,160,139,101,2.88,4,3,university_of_texas_dallas,reject,52
314,164,150,90.0,2.3,42,0,university_of_texas_dallas,reject,52
315,168,147,91.0,2.9,0,0,university_of_texas_dallas,reject,52
315,168,147,91.0,2.9,0,0,university_of_texas_dallas,reject,52
315,161,154,105.0,2.95,2,2,university_of_texas_dallas,reject,52
327,162,165,117.0,2.79,0,0,university_of_texas_dallas,reject,52
308,159,149,90.0,2.92,47,0,university_of_texas_dallas,reject,52
314,163,151,108.0,1.88,54,2,university_of_texas_dallas,reject,52
331,168,163,109.0,2.25,6,0,university_of_texas_dallas,reject,52
317,165,152,108.0,2.6,10,0,university_of_texas_dallas,reject,52
310,161,149,100.0,2.92,4,0,university_of_texas_dallas,reject,52
301,160,141,65.0,3.65,14,0,university_of_texas_dallas,reject,52
324,169,155,110.0,2.51,13,3,university_of_texas_dallas,reject,52
307,159,148,106.0,3.36,0,3,university_of_texas_dallas,reject,52
316,163,153,100.0,2.67,40,0,university_of_texas_dallas,reject,52
304,156,148,114,3.12,9,3,university_of_texas_dallas,reject,52
320,168,152,99.0,3.3,25,3,university_of_texas_dallas,reject,52
320,158,162,112.0,3.03,25,2,university_of_texas_dallas,reject,52
305,161,144,75.0,3.12,20,0,university_of_texas_dallas,reject,52
321,170,151,100.0,3.06,2,0,university_of_texas_dallas,reject,52
303,159,144,100.0,2.95,25,0,university_of_texas_dallas,reject,52
314,165,149,102.0,2.8,20,0,university_of_texas_dallas,reject,52
310,158,152,58.0,2.5,42,0,university_of_texas_dallas,reject,52
310,160,150,103.0,2.4,17,0,university_of_texas_dallas,reject,52
304,157,147,114,2.58,0,3,university_of_texas_dallas,reject,52
307,163,144,99.0,3.36,0,0,university_of_texas_dallas,reject,52
324,166,158,105.0,2.62,1,0,university_of_texas_dallas,reject,52
302,159,143,99.0,2.81,17,0,university_of_texas_dallas,reject,52
312,166,146,98.0,3.09,30,2,university_of_texas_dallas,reject,52
305,161,144,95.0,3.23,4,0,university_of_texas_dallas,reject,52
305,157,148,90.0,2.23,48,0,university_of_texas_dallas,reject,52
319,167,152,75.0,2.5,13,0,university_of_texas_dallas,reject,52
309,157,152,98.0,2.63,17,0,university_of_texas_dallas,reject,52
310,163,147,97.0,2.8,11,3,university_of_texas_dallas,reject,52
315,163,152,113.0,2.75,43,0,university_of_texas_dallas,reject,52
304,162,142,90.0,2.99,16,0,university_of_texas_dallas,reject,52
302,159,143,92.0,3.28,0,0,university_of_texas_dallas,reject,52
318,164,154,112.0,2.98,14,0,university_of_texas_dallas,reject,52
318,164,154,112.0,2.98,14,0,university_of_texas_dallas,reject,52
299,151,148,101,3.0,35,0,university_of_texas_dallas,reject,52
312,162,150,102.0,2.52,30,3,university_of_texas_dallas,reject,52
300,160,140,65.0,2.65,12,0,university_of_texas_dallas,reject,52
302,160,142,86.0,2.56,60,0,university_of_texas_dallas,reject,52
313,164,149,100.0,2.82,1,3,university_of_texas_dallas,reject,52
309,163,146,93.0,2.87,3,3,university_of_texas_dallas,reject,52
314,161,153,102.0,2.52,1,0,university_of_texas_dallas,reject,52
312,160,152,96.0,2.98,1,0,university_of_texas_dallas,reject,52
317,163,154,109.0,2.45,28,0,university_of_texas_dallas,reject,52
295,158,137,101,2.45,0,0,university_of_texas_dallas,reject,52
309,166,143,101,3.39,17,0,university_of_texas_dallas,reject,52
302,163,139,80.0,2.73,12,3,university_of_texas_dallas,reject,52
312,159,153,95.0,2.95,20,0,university_of_texas_dallas,reject,52
313,160,153,75.0,3.09,21,3,university_of_texas_dallas,reject,52
313,164,149,97.0,2.85,5,0,university_of_texas_dallas,reject,52
315,168,147,103.0,2.7,40,3,university_of_texas_dallas,reject,52
318,164,154,99.0,3.12,12,0,university_of_texas_dallas,reject,52
314,161,153,100.0,2.63,28,3,university_of_texas_dallas,reject,52
308,159,149,102.0,2.81,8,0,university_of_texas_dallas,reject,52
312,168,144,88.0,2.45,30,0,university_of_texas_dallas,reject,52
312,168,144,88.0,2.45,30,0,university_of_texas_dallas,reject,52
313,168,145,101.0,3.14,0,0,university_of_texas_dallas,reject,52
328,169,159,116.0,2.94,4,0,university_of_texas_dallas,reject,52
311,161,150,104.0,2.1,18,0,university_of_texas_dallas,reject,52
300,155,145,105.0,3.23,0,3,university_of_texas_dallas,reject,52
320,167,153,109.0,2.63,18,0,university_of_texas_dallas,reject,52
311,167,144,101.0,3.2,6,3,university_of_texas_dallas,reject,52
311,161,150,106.0,3.08,54,0,university_of_texas_dallas,reject,52
326,165,161,103.0,2.53,0,3,university_of_texas_dallas,reject,52
312,164,148,75.0,2.6,33,0,university_of_texas_dallas,reject,52
313,160,153,102.0,2.55,60,0,university_of_texas_dallas,reject,52
311,164,147,112.0,3.12,15,0,university_of_texas_dallas,reject,52
312,161,151,96.0,2.75,22,0,university_of_texas_dallas,reject,52
304,161,143,94.0,3.55,46,0,university_of_texas_dallas,reject,52
314,164,150,102.0,2.67,15,0,university_of_texas_dallas,reject,52
318,166,152,109.0,3.02,23,0,university_of_texas_dallas,reject,52
321,169,152,99.0,2.49,18,0,university_of_texas_dallas,reject,52
309,159,150,105.0,2.48,20,1,university_of_texas_dallas,reject,52
304,160,144,93.0,3.36,2,3,university_of_texas_dallas,reject,52
311,159,152,95.0,3.0,20,0,university_of_texas_dallas,reject,52
311,159,152,95.0,3.0,20,0,university_of_texas_dallas,reject,52
312,163,149,75.0,2.7,28,0,university_of_texas_dallas,reject,52
318,163,155,114.0,2.94,24,0,university_of_texas_dallas,reject,52
311,159,152,109.0,2.6,28,2,university_of_texas_dallas,reject,52
319,164,155,106.0,3.0,5,0,university_of_texas_dallas,reject,52
308,160,148,75.0,2.85,17,0,university_of_texas_dallas,reject,52
309,162,147,107.0,2.42,26,1,university_of_texas_dallas,reject,52
324,161,163,115.0,1.9,60,0,university_of_texas_dallas,reject,52
303,160,143,65.0,2.98,32,0,university_of_texas_dallas,reject,52
317,168,149,104.0,3.06,19,0,university_of_texas_dallas,reject,52
304,155,149,99.0,2.45,37,0,university_of_texas_dallas,reject,52
310,159,151,104.0,3.29,26,0,university_of_texas_dallas,reject,52
312,161,151,98.0,2.47,33,3,university_of_texas_dallas,reject,52
303,153,150,99.0,3.04,21,2,university_of_texas_dallas,reject,52
309,167,142,86.0,2.58,26,0,university_of_texas_dallas,reject,52
313,160,153,101.0,3.1,0,3,university_of_texas_dallas,reject,52
307,158,149,101,3.16,0,0,university_of_texas_dallas,reject,52
305,162,143,93.0,3.27,2,3,university_of_texas_dallas,reject,52
311,168,143,91.0,2.83,6,0,university_of_texas_dallas,reject,52
310,162,148,105.0,2.0,60,0,university_of_texas_dallas,reject,52
319,162,157,106.0,2.83,5,2,university_of_iowa,accept,71
319,162,157,106.0,2.83,5,2,university_of_iowa,accept,71
308,161,147,101.0,2.54,25,0,university_of_iowa,accept,71
304,157,147,75.0,3.03,2,0,university_of_iowa,accept,71
312,160,152,114,2.25,12,3,university_of_iowa,accept,71
315,163,152,104.0,2.74,0,0,university_of_iowa,accept,71
311,159,152,95.0,3.0,20,0,university_of_iowa,accept,71
319,163,156,110.0,3.14,60,0,university_of_iowa,accept,71
318,164,154,109.0,2.17,1,0,university_of_iowa,accept,71
316,167,149,109.0,3.11,0,0,university_of_iowa,accept,71
311,159,152,0,2.23,0,0,university_of_iowa,accept,71
310,160,150,103.0,2.04,55,0,university_of_iowa,accept,71
316,161,155,102.0,2.8,24,0,university_of_iowa,accept,71
314,164,150,105.0,2.73,0,0,university_of_iowa,accept,71
312,162,150,97.0,2.76,0,0,university_of_iowa,accept,71
323,164,159,109.0,2.79,5,0,university_of_iowa,accept,71
319,162,157,106.0,2.83,5,2,university_of_iowa,accept,71
319,162,157,106.0,2.83,5,2,university_of_iowa,accept,71
309,160,149,112.0,2.76,60,0,university_of_iowa,accept,71
304,157,147,75.0,3.03,2,0,university_of_iowa,accept,71
312,160,152,114,2.25,12,3,university_of_iowa,accept,71
315,163,152,104.0,2.74,0,0,university_of_iowa,accept,71
310,164,146,91.0,2.2,42,0,university_of_iowa,accept,71
319,163,156,110.0,3.14,60,0,university_of_iowa,accept,71
318,164,154,109.0,2.17,1,0,university_of_iowa,accept,71
316,167,149,109.0,3.11,0,0,university_of_iowa,accept,71
313,165,148,0,2.58,10,2,university_of_iowa,accept,71
310,160,150,103.0,2.04,55,0,university_of_iowa,accept,71
316,161,155,102.0,2.8,24,0,university_of_iowa,accept,71
309,160,149,99.0,2.61,32,0,university_of_iowa,accept,71
312,162,150,97.0,2.76,0,0,university_of_iowa,accept,71
323,164,159,109.0,2.79,5,0,university_of_iowa,accept,71
315,162,153,107.0,2.8,3,3,university_of_iowa,accept,71
317,165,152,108.0,3.07,0,1,university_of_iowa,accept,71
291,151,140,93.0,2.75,19,3,university_of_iowa,accept,71
312,163,149,107.0,2.85,55,0,university_of_iowa,accept,71
315,166,149,96.0,2.95,18,0,university_of_iowa,accept,71
322,168,154,107.0,2.7,0,0,university_of_iowa,accept,71
308,164,144,91.0,2.9,30,0,university_of_iowa,accept,71
305,162,143,90.0,2.88,20,1,university_of_iowa,accept,71
311,166,145,100.0,3.28,20,0,university_of_iowa,accept,71
312,164,148,101.0,2.86,0,0,university_of_iowa,accept,71
321,168,153,105.0,2.52,0,0,university_of_iowa,accept,71
310,161,149,101,2.5,14,0,university_of_iowa,reject,71
310,161,149,101,2.5,14,0,university_of_iowa,reject,71
315,165,150,97.0,2.32,5,0,university_of_iowa,reject,71
300,156,144,83.0,2.96,35,0,university_of_iowa,reject,71
304,153,151,96.0,2.7,0,0,university_of_iowa,reject,71
317,157,160,108.0,2.6,20,1,university_of_iowa,reject,71
311,160,151,104.0,2.1,38,1,university_of_iowa,reject,71
308,158,150,81.0,3.39,24,0,university_of_iowa,reject,71
310,161,149,101,2.5,14,0,university_of_iowa,reject,71
310,161,149,101,2.5,14,0,university_of_iowa,reject,71
315,165,150,97.0,2.32,5,0,university_of_iowa,reject,71
300,156,144,83.0,2.96,35,0,university_of_iowa,reject,71
304,153,151,96.0,2.7,0,0,university_of_iowa,reject,71
317,157,160,108.0,2.6,20,1,university_of_iowa,reject,71
311,160,151,104.0,2.1,38,1,university_of_iowa,reject,71
308,158,150,81.0,3.39,24,0,university_of_iowa,reject,71
299,161,138,65.0,3.3,0,0,university_of_cincinnati,accept,130
327,170,157,96.0,1.75,22,0,university_of_cincinnati,accept,130
302,158,144,75.0,3.86,0,0,university_of_cincinnati,accept,130
305,145,160,101.0,1.95,50,2,university_of_cincinnati,accept,130
302,154,148,101,3.2,30,0,university_of_cincinnati,accept,130
302,158,144,65.0,1.75,0,0,university_of_cincinnati,accept,130
303,161,142,65.0,3.1,0,3,university_of_cincinnati,accept,130
312,163,149,75.0,3.09,23,0,university_of_cincinnati,accept,130
312,169,143,101,2.49,30,0,university_of_cincinnati,accept,130
306,161,145,105.0,3.78,25,2,university_of_cincinnati,accept,130
302,160,142,101,2.96,33,0,university_of_cincinnati,accept,130
313,162,151,111.0,3.36,21,0,university_of_cincinnati,accept,130
303,156,147,75.0,2.94,8,0,university_of_cincinnati,accept,130
308,160,148,102.0,2.61,10,3,university_of_cincinnati,accept,130
312,159,153,75.0,3.38,0,0,university_of_cincinnati,accept,130
315,165,150,92.0,2.66,13,0,university_of_cincinnati,accept,130
315,166,149,101.0,2.5,15,0,university_of_cincinnati,accept,130
303,158,145,101,2.9,36,0,university_of_cincinnati,accept,130
309,161,148,65.0,3.25,20,0,university_of_cincinnati,accept,130
309,161,148,65.0,3.25,20,0,university_of_cincinnati,accept,130
305,160,145,101,3.0,2,0,university_of_cincinnati,accept,130
304,163,141,101,3.38,2,0,university_of_cincinnati,accept,130
305,154,151,65.0,2.15,14,2,university_of_cincinnati,accept,130
293,156,137,101,2.8,0,0,university_of_cincinnati,accept,130
303,162,141,96.0,2.96,20,3,university_of_cincinnati,accept,130
310,158,152,75.0,3.13,24,0,university_of_cincinnati,accept,130
310,164,146,97.0,3.0,9,0,university_of_cincinnati,accept,130
305,154,151,75.0,3.48,0,0,university_of_cincinnati,accept,130
311,164,147,89.0,3.65,2,0,university_of_cincinnati,accept,130
298,158,140,65.0,3.27,8,0,university_of_cincinnati,accept,130
300,166,134,65.0,3.47,18,1,university_of_cincinnati,accept,130
302,157,145,101,2.25,60,3,university_of_cincinnati,accept,130
305,160,145,105.0,2.52,6,0,university_of_cincinnati,accept,130
318,162,156,114,3.46,2,0,university_of_cincinnati,accept,130
300,155,145,105.0,3.23,0,3,university_of_cincinnati,accept,130
320,169,151,101.0,3.63,9,0,university_of_cincinnati,accept,130
320,169,151,101.0,3.63,9,0,university_of_cincinnati,accept,130
302,154,148,75.0,3.18,32,0,university_of_cincinnati,accept,130
301,155,146,65.0,2.32,38,0,university_of_cincinnati,accept,130
305,153,152,93.0,2.52,0,0,university_of_cincinnati,accept,130
303,156,147,87.0,3.08,27,0,university_of_cincinnati,accept,130
311,164,147,99.0,2.85,11,0,university_of_cincinnati,accept,130
302,158,144,101,2.81,0,0,university_of_cincinnati,accept,130
312,160,152,96.0,2.85,0,0,university_of_cincinnati,accept,130
310,159,151,93.0,2.78,14,0,university_of_cincinnati,accept,130
317,166,151,106.0,3.12,32,0,university_of_cincinnati,accept,130
314,163,151,101,2.84,0,0,university_of_cincinnati,accept,130
308,164,144,75.0,3.16,17,0,university_of_cincinnati,accept,130
307,163,144,94.0,2.84,0,0,university_of_cincinnati,accept,130
305,160,145,75.0,3.23,1,0,university_of_cincinnati,accept,130
314,161,153,101,3.15,12,0,university_of_cincinnati,accept,130
302,157,145,95.0,2.05,30,0,university_of_cincinnati,accept,130
307,162,145,65.0,3.1,12,0,university_of_cincinnati,accept,130
302,159,143,65.0,3.58,0,0,university_of_cincinnati,accept,130
310,159,151,75.0,3.27,32,0,university_of_cincinnati,accept,130
310,159,151,75.0,3.27,32,0,university_of_cincinnati,accept,130
318,166,152,110.0,3.5,53,3,university_of_cincinnati,accept,130
313,164,149,65.0,3.5,19,0,university_of_cincinnati,accept,130
305,163,142,101,3.67,0,0,university_of_cincinnati,accept,130
296,153,143,65.0,3.72,0,0,university_of_cincinnati,accept,130
314,161,153,102.0,2.52,1,0,university_of_cincinnati,accept,130
305,157,148,75.0,3.44,0,2,university_of_cincinnati,accept,130
314,152,162,99.0,2.55,38,0,university_of_cincinnati,accept,130
313,161,152,108.0,2.68,31,0,university_of_cincinnati,accept,130
309,163,146,90.0,3.43,20,3,university_of_cincinnati,accept,130
308,166,142,91.0,3.44,8,0,university_of_cincinnati,accept,130
318,167,151,101,3.2,14,0,university_of_cincinnati,accept,130
305,165,140,101,3.54,0,0,university_of_cincinnati,accept,130
300,159,141,65.0,3.29,17,0,university_of_cincinnati,accept,130
306,156,150,106.0,2.88,13,0,university_of_cincinnati,accept,130
305,153,152,107.0,2.75,24,0,university_of_cincinnati,accept,130
304,158,146,65.0,3.4,41,0,university_of_cincinnati,accept,130
304,155,149,99.0,2.45,37,0,university_of_cincinnati,accept,130
304,155,149,99.0,2.45,37,0,university_of_cincinnati,accept,130
300,155,145,105.0,3.23,0,3,university_of_cincinnati,accept,130
310,160,150,106.0,2.8,9,0,university_of_cincinnati,accept,130
302,159,143,75.0,3.74,3,0,university_of_cincinnati,accept,130
328,169,159,116.0,2.94,4,0,university_of_cincinnati,accept,130
314,164,150,103.0,3.2,3,1,university_of_cincinnati,accept,130
305,160,145,101,3.11,17,0,university_of_cincinnati,accept,130
305,161,144,75.0,3.12,20,0,university_of_cincinnati,accept,130
320,166,154,103.0,2.97,25,0,university_of_cincinnati,accept,130
307,167,140,101,2.86,18,0,university_of_cincinnati,accept,130
321,166,155,104.0,3.37,8,0,university_of_cincinnati,accept,130
315,161,154,97.0,3.47,0,0,university_of_cincinnati,accept,130
317,168,149,75.0,3.52,0,0,university_of_cincinnati,accept,130
306,154,152,101.0,2.45,27,2,university_of_cincinnati,accept,130
307,162,145,101,2.95,24,0,university_of_cincinnati,accept,130
305,157,148,101,2.86,30,0,university_of_cincinnati,accept,130
301,156,145,75.0,3.72,18,0,university_of_cincinnati,accept,130
310,156,154,103.0,3.17,18,0,university_of_cincinnati,accept,130
315,165,150,101,3.0,36,0,university_of_cincinnati,accept,130
315,165,150,101,3.0,36,0,university_of_cincinnati,accept,130
299,155,144,75.0,2.88,22,0,university_of_cincinnati,accept,130
306,159,147,91.0,3.03,38,0,university_of_cincinnati,accept,130
311,167,144,75.0,3.32,0,0,university_of_cincinnati,accept,130
308,160,148,65.0,3.33,14,0,university_of_cincinnati,accept,130
315,164,151,93.0,2.43,14,0,university_of_cincinnati,accept,130
318,160,158,114,3.29,18,0,university_of_cincinnati,accept,130
311,163,148,105.0,1.25,0,0,university_of_cincinnati,accept,130
315,158,157,114.0,3.55,0,0,university_of_cincinnati,accept,130
309,163,146,101,2.9,26,0,university_of_cincinnati,accept,130
300,159,141,65.0,3.29,18,0,university_of_cincinnati,accept,130
313,165,148,101,2.96,16,0,university_of_cincinnati,accept,130
304,161,143,65.0,2.7,38,0,university_of_cincinnati,accept,130
309,162,147,75.0,2.97,22,0,university_of_cincinnati,accept,130
309,166,143,101,3.39,17,0,university_of_cincinnati,accept,130
317,167,150,92.0,3.06,25,0,university_of_cincinnati,accept,130
313,164,149,97.0,2.85,5,0,university_of_cincinnati,accept,130
304,158,146,95.0,3.68,0,0,university_of_cincinnati,accept,130
304,158,146,95.0,3.68,0,0,university_of_cincinnati,accept,130
315,164,151,109.0,3.38,25,0,university_of_cincinnati,accept,130
305,160,145,65.0,3.55,6,1,university_of_cincinnati,accept,130
306,161,145,93.0,3.36,0,0,university_of_cincinnati,accept,130
313,161,152,114,3.82,1,0,university_of_cincinnati,accept,130
328,167,161,114.0,3.42,2,0,university_of_cincinnati,accept,130
321,163,158,110.0,3.37,6,0,university_of_cincinnati,accept,130
306,165,141,85.0,3.62,20,0,university_of_cincinnati,accept,130
310,159,151,101.0,3.4,6,3,university_of_cincinnati,accept,130
308,160,148,92.0,3.34,20,0,university_of_cincinnati,accept,130
309,165,144,101.0,2.99,4,3,university_of_cincinnati,accept,130
310,161,149,75.0,2.95,0,0,university_of_cincinnati,accept,130
316,160,156,113.0,3.14,2,3,university_of_cincinnati,accept,130
319,168,151,65.0,3.3,13,0,university_of_cincinnati,accept,130
307,162,145,95.0,2.64,1,0,university_of_cincinnati,accept,130
312,168,144,75.0,3.48,0,0,university_of_cincinnati,accept,130
312,166,146,75.0,2.73,18,0,university_of_cincinnati,accept,130
304,164,140,65.0,3.2,28,0,university_of_cincinnati,accept,130
315,162,153,114,3.38,6,0,university_of_cincinnati,accept,130
308,160,148,75.0,2.85,17,0,university_of_cincinnati,accept,130
312,160,152,102.0,2.96,6,0,university_of_cincinnati,accept,130
312,160,152,102.0,2.96,6,0,university_of_cincinnati,accept,130
303,162,141,65.0,3.7,40,0,university_of_cincinnati,accept,130
310,164,146,100.0,3.36,48,0,university_of_cincinnati,accept,130
307,166,141,90.0,2.96,26,3,university_of_cincinnati,accept,130
307,163,144,101,3.6,16,0,university_of_cincinnati,accept,130
315,162,153,109.0,3.89,1,0,university_of_cincinnati,accept,130
305,164,141,90.0,3.65,13,2,university_of_cincinnati,accept,130
300,156,144,88.0,3.16,14,0,university_of_cincinnati,accept,130
300,158,142,89.0,3.53,18,0,university_of_cincinnati,accept,130
304,158,146,101,2.55,24,0,university_of_cincinnati,accept,130
304,157,147,65.0,2.75,14,2,university_of_cincinnati,accept,130
311,162,149,85.0,3.36,0,0,university_of_cincinnati,accept,130
301,148,153,101,3.2,0,0,university_of_cincinnati,accept,130
304,164,140,65.0,2.55,0,0,university_of_cincinnati,accept,130
300,158,142,75.0,2.5,0,0,university_of_cincinnati,accept,130
319,164,155,107.0,3.56,18,0,university_of_cincinnati,accept,130
304,156,148,92.0,2.05,33,0,university_of_cincinnati,accept,130
303,162,141,91.0,1.6,12,0,university_of_cincinnati,accept,130
301,162,139,101,3.24,7,0,university_of_cincinnati,accept,130
310,160,150,0,2.6,2,0,university_of_cincinnati,accept,130
313,166,147,96.0,2.75,32,0,university_of_cincinnati,accept,130
314,157,157,110.0,2.28,20,0,university_of_cincinnati,accept,130
313,165,148,91.0,3.06,28,0,university_of_cincinnati,accept,130
312,165,147,101,3.15,0,0,university_of_cincinnati,accept,130
313,163,150,101,3.11,5,0,university_of_cincinnati,accept,130
310,166,144,114,2.42,0,0,university_of_cincinnati,accept,130
302,160,142,101,2.79,60,0,university_of_cincinnati,accept,130
303,153,150,75.0,2.22,36,0,university_of_cincinnati,accept,130
303,153,150,75.0,2.22,36,0,university_of_cincinnati,accept,130
303,140,163,101,3.8,33,0,university_of_cincinnati,accept,130
310,158,152,75.0,2.36,0,0,university_of_cincinnati,accept,130
311,159,152,107.0,3.58,24,0,university_of_cincinnati,accept,130
312,163,149,0,3.61,6,0,university_of_cincinnati,accept,130
306,161,145,75.0,2.89,18,3,university_of_cincinnati,accept,130
306,163,143,65.0,2.9,0,0,university_of_cincinnati,accept,130
305,161,144,86.0,2.65,36,0,university_of_cincinnati,accept,130
315,166,149,0,3.08,4,0,university_of_cincinnati,accept,130
311,162,149,85.0,3.4,0,0,university_of_cincinnati,accept,130
320,164,156,75.0,3.4,1,0,university_of_cincinnati,accept,130
304,162,142,101,3.09,6,0,university_of_cincinnati,accept,130
306,144,162,98.0,3.5,17,2,university_of_cincinnati,accept,130
313,165,148,75.0,3.09,0,0,university_of_cincinnati,accept,130
313,164,149,75.0,2.85,6,0,university_of_cincinnati,accept,130
302,160,142,97.0,3.18,32,0,university_of_cincinnati,accept,130
304,163,141,101,2.87,0,0,university_of_cincinnati,accept,130
302,159,143,101,3.35,30,2,university_of_cincinnati,accept,130
303,153,150,101,3.0,20,0,university_of_cincinnati,accept,130
306,162,144,107.0,3.24,0,0,university_of_cincinnati,accept,130
311,163,148,0,3.15,17,0,university_of_cincinnati,accept,130
311,163,148,0,3.15,17,0,university_of_cincinnati,accept,130
307,158,149,87.0,3.23,0,0,university_of_cincinnati,accept,130
313,161,152,106.0,3.1,0,3,university_of_cincinnati,accept,130
306,164,142,92.0,2.46,34,0,university_of_cincinnati,accept,130
308,162,146,101,2.9,0,0,university_of_cincinnati,accept,130
316,163,153,96.0,2.86,4,0,university_of_cincinnati,accept,130
306,160,146,0,3.1,18,0,university_of_cincinnati,accept,130
303,160,143,92.0,2.31,18,0,university_of_cincinnati,accept,130
309,162,147,99.0,2.6,4,0,university_of_cincinnati,accept,130
310,165,145,90.0,3.47,0,0,university_of_cincinnati,accept,130
305,161,144,0,3.08,2,0,university_of_cincinnati,accept,130
318,163,155,110.0,2.82,6,0,university_of_cincinnati,accept,130
308,162,146,95.0,3.04,50,0,university_of_cincinnati,accept,130
307,158,149,107.0,2.92,12,0,university_of_cincinnati,accept,130
300,160,140,104.0,3.6,39,0,university_of_cincinnati,accept,130
314,165,149,108.0,2.08,0,1,university_of_cincinnati,accept,130
313,165,148,107.0,2.4,0,0,university_of_cincinnati,accept,130
319,162,157,104.0,3.3,18,0,university_of_cincinnati,accept,130
314,163,151,114.0,2.27,18,0,university_of_cincinnati,accept,130
327,167,160,0,2.5,48,0,university_of_cincinnati,accept,130
295,156,139,65.0,3.48,0,0,university_of_cincinnati,reject,130
295,156,139,65.0,3.48,0,0,university_of_cincinnati,reject,130
301,167,134,65.0,3.35,0,0,university_of_cincinnati,reject,130
311,166,145,75.0,3.07,50,0,university_of_cincinnati,reject,130
301,159,142,101,3.38,0,0,university_of_cincinnati,reject,130
290,149,141,65.0,3.25,0,0,university_of_cincinnati,reject,130
292,150,142,87.0,3.1,0,3,university_of_cincinnati,reject,130
297,154,143,75.0,2.11,0,0,university_of_cincinnati,reject,130
298,161,137,85.0,2.92,28,3,university_of_cincinnati,reject,130
304,160,144,87.0,3.44,42,0,university_of_cincinnati,reject,130
307,161,146,101,2.85,0,0,university_of_cincinnati,reject,130
308,161,147,105.0,2.92,1,0,university_of_cincinnati,reject,130
316,162,154,106.0,2.0,0,0,university_of_cincinnati,reject,130
316,164,152,91.0,2.6,0,0,university_of_cincinnati,reject,130
301,156,145,65.0,2.78,3,0,university_of_cincinnati,reject,130
307,158,149,105.0,2.72,10,3,university_of_cincinnati,reject,130
310,165,145,65.0,2.81,16,0,university_of_cincinnati,reject,130
305,164,141,0,2.64,32,0,university_of_cincinnati,reject,130
311,163,148,93.0,1.13,0,0,university_of_cincinnati,reject,130
307,160,147,111.0,2.8,0,0,university_of_cincinnati,reject,130
292,149,143,101.0,2.7,24,2,university_of_cincinnati,reject,130
313,162,151,97.0,3.12,28,0,university_of_cincinnati,reject,130
313,162,151,97.0,3.12,28,0,university_of_cincinnati,reject,130
308,160,148,0,2.1,30,2,university_of_cincinnati,reject,130
324,170,154,98.0,2.36,0,0,university_of_cincinnati,reject,130
292,148,144,84.0,3.15,0,0,university_of_cincinnati,reject,130
321,167,154,110.0,2.88,13,0,university_of_cincinnati,reject,130
301,158,143,92.0,2.55,20,0,university_of_cincinnati,reject,130
312,162,150,95.0,2.8,0,0,university_of_cincinnati,reject,130
319,164,155,109.0,3.16,0,0,university_of_cincinnati,reject,130
314,162,152,107.0,3.32,0,0,university_of_cincinnati,reject,130
311,160,151,104.0,2.1,38,1,university_of_cincinnati,reject,130
302,158,144,96.0,2.3,10,0,university_of_cincinnati,reject,130
308,160,148,111.0,1.76,30,0,university_of_cincinnati,reject,130
300,156,144,87.0,2.35,0,1,university_of_cincinnati,reject,130
306,160,146,93.0,3.52,30,2,university_of_cincinnati,reject,130
313,163,150,103.0,2.8,30,2,university_of_cincinnati,reject,130
309,155,154,111.0,3.15,0,0,university_of_cincinnati,reject,130
317,163,154,99.0,2.5,0,0,university_of_cincinnati,reject,130
307,162,145,82.0,2.73,0,0,university_of_cincinnati,reject,130
316,162,154,93.0,2.25,0,0,university_of_cincinnati,reject,130
316,162,154,93.0,2.25,0,0,university_of_cincinnati,reject,130
319,165,154,107.0,3.4,0,3,worcester_polytechnic_institute,accept,79
313,166,147,106.0,3.28,1,3,worcester_polytechnic_institute,accept,79
324,169,155,107.0,3.27,20,0,worcester_polytechnic_institute,accept,79
309,160,149,104.0,3.66,33,1,worcester_polytechnic_institute,accept,79
312,157,155,85.0,3.51,3,1,worcester_polytechnic_institute,accept,79
314,166,148,103.0,2.85,18,3,worcester_polytechnic_institute,accept,79
310,164,146,94.0,3.79,0,0,worcester_polytechnic_institute,accept,79
318,159,159,113.0,3.08,10,0,worcester_polytechnic_institute,accept,79
310,157,153,99.0,2.55,6,3,worcester_polytechnic_institute,accept,79
311,160,151,94.0,2.72,52,0,worcester_polytechnic_institute,accept,79
316,163,153,114.0,3.78,24,1,worcester_polytechnic_institute,accept,79
311,162,149,100.0,3.08,0,0,worcester_polytechnic_institute,accept,79
303,155,148,99.0,3.24,2,0,worcester_polytechnic_institute,accept,79
315,167,148,93.0,3.0,2,0,worcester_polytechnic_institute,accept,79
308,159,149,92.0,3.6,1,0,worcester_polytechnic_institute,accept,79
321,167,154,102.0,1.52,60,0,worcester_polytechnic_institute,accept,79
322,163,159,109.0,2.46,7,0,worcester_polytechnic_institute,accept,79
309,161,148,99.0,2.37,16,0,worcester_polytechnic_institute,accept,79
309,161,148,99.0,2.37,16,0,worcester_polytechnic_institute,accept,79
309,160,149,97.0,3.28,18,3,worcester_polytechnic_institute,accept,79
302,155,147,101,2.05,1,0,worcester_polytechnic_institute,accept,79
303,151,152,100.0,1.8,0,3,worcester_polytechnic_institute,accept,79
315,163,152,108.0,2.1,6,3,worcester_polytechnic_institute,accept,79
326,169,157,104.0,2.39,40,3,worcester_polytechnic_institute,accept,79
308,157,151,95.0,2.38,0,3,worcester_polytechnic_institute,accept,79
316,161,155,107.0,3.55,0,3,worcester_polytechnic_institute,accept,79
302,153,149,98.0,2.0,52,0,worcester_polytechnic_institute,accept,79
298,156,142,90.0,2.08,0,2,worcester_polytechnic_institute,accept,79
320,168,152,110.0,2.5,30,0,worcester_polytechnic_institute,accept,79
306,161,145,91.0,3.65,20,0,worcester_polytechnic_institute,accept,79
311,162,149,103.0,3.2,6,0,worcester_polytechnic_institute,accept,79
317,169,148,101.0,3.05,30,0,worcester_polytechnic_institute,accept,79
316,164,152,94.0,3.49,10,1,worcester_polytechnic_institute,accept,79
304,160,144,83.0,3.4,18,0,worcester_polytechnic_institute,reject,79
304,160,144,83.0,3.4,18,0,worcester_polytechnic_institute,reject,79
313,156,157,114,2.25,1,0,worcester_polytechnic_institute,reject,79
312,147,165,106.0,2.75,15,3,worcester_polytechnic_institute,reject,79
303,160,143,93.0,3.03,19,0,worcester_polytechnic_institute,reject,79
304,155,149,92.0,2.59,38,0,worcester_polytechnic_institute,reject,79
303,154,149,102.0,2.05,1,0,worcester_polytechnic_institute,reject,79
299,159,140,86.0,2.99,15,0,worcester_polytechnic_institute,reject,79
308,157,151,93.0,1.28,0,0,worcester_polytechnic_institute,reject,79
301,159,142,87.0,2.83,15,0,worcester_polytechnic_institute,reject,79
303,152,151,100.0,3.0,24,3,worcester_polytechnic_institute,reject,79
301,159,142,65.0,2.86,15,0,worcester_polytechnic_institute,reject,79
315,165,150,104.0,3.12,3,2,worcester_polytechnic_institute,reject,79
314,162,152,105.0,3.06,2,3,worcester_polytechnic_institute,reject,79
305,158,147,97.0,3.47,3,3,worcester_polytechnic_institute,reject,79
319,167,152,103.0,1.96,27,0,worcester_polytechnic_institute,reject,79
315,164,151,103.0,2.0,30,3,worcester_polytechnic_institute,reject,79
317,165,152,111.0,3.25,6,0,worcester_polytechnic_institute,reject,79
306,159,147,95.0,2.84,0,0,worcester_polytechnic_institute,reject,79
303,162,141,91.0,3.07,17,0,worcester_polytechnic_institute,reject,79
306,163,143,101,1.72,18,3,worcester_polytechnic_institute,reject,79
304,158,146,85.0,3.12,0,0,worcester_polytechnic_institute,reject,79
304,158,146,85.0,3.12,0,0,worcester_polytechnic_institute,reject,79
307,155,152,104.0,1.95,5,3,worcester_polytechnic_institute,reject,79
304,149,155,88.0,2.36,46,0,worcester_polytechnic_institute,reject,79
310,164,146,97.0,3.11,24,0,worcester_polytechnic_institute,reject,79
306,157,149,91.0,2.17,25,0,worcester_polytechnic_institute,reject,79
307,162,145,93.0,2.25,30,2,worcester_polytechnic_institute,reject,79
306,158,148,100.0,2.65,18,0,worcester_polytechnic_institute,reject,79
318,168,150,106.0,1.88,18,3,worcester_polytechnic_institute,reject,79
327,170,157,117.0,3.28,6,3,worcester_polytechnic_institute,reject,79
317,161,156,108.0,1.9,14,0,worcester_polytechnic_institute,reject,79
316,158,158,113.0,2.5,3,0,worcester_polytechnic_institute,reject,79
304,161,143,86.0,1.9,0,0,worcester_polytechnic_institute,reject,79
315,164,151,90.0,2.2,0,0,worcester_polytechnic_institute,reject,79
309,164,145,100.0,3.38,33,0,worcester_polytechnic_institute,reject,79
294,154,140,86.0,2.85,30,0,worcester_polytechnic_institute,reject,79
